AGCAACAACCGTGCCTGTC -> GCAACAACCGTGCCTGTCC
CTGCAATACGTGCGTCTGA -> TGCAATACGTGCGTCTGAA
AGCTGGGAGCCAAATTAGT -> GCTGGGAGCCAAATTAGTC
GGCTGCCGAGGCTAGCCAC -> GCTGCCGAGGCTAGCCACT
GCCGTAGTACCAGGGCCTA -> CCGTAGTACCAGGGCCTAC
ATGGCCACTAATTGTCCTG -> TGGCCACTAATTGTCCTGG
AGGCTTAATTTGGGATTAT -> GGCTTAATTTGGGATTATC
AAGTAAGTATGTATATCAT -> AGTAAGTATGTATATCATG
CGCCCTGTTGACCGAAAGT -> GCCCTGTTGACCGAAAGTA
GTAAGGCCAAGGACGCTAT -> TAAGGCCAAGGACGCTATC
GGAAATCGGGACACAAGTG -> GAAATCGGGACACAAGTGC
GAGTACGGTATCCCATTGA -> AGTACGGTATCCCATTGAT
CTACATAGCTGACGATAGT -> TACATAGCTGACGATAGTA
CCAAGGACGCACCCCGTAT -> CAAGGACGCACCCCGTATG
TTTCGTGCATGTTTAGGCG -> TTCGTGCATGTTTAGGCGG
CGGACTTTGAGGCGAGTAC -> GGACTTTGAGGCGAGTACT
CTTGCGTGTCACATTCGAA -> TTGCGTGTCACATTCGAAG
AATTCTCGCCGTAGTACCA -> ATTCTCGCCGTAGTACCAG
ATATCATGTAAAACTGCTT -> TATCATGTAAAACTGCTTG
ATTCGAAGTTTCTTCATTA -> TTCGAAGTTTCTTCATTAA
AGTGCTAGCCTGACTCCCT -> GTGCTAGCCTGACTCCCTT
ATCCCATTGATGCACCATT -> TCCCATTGATGCACCATTT
ACCAGGACGACCCCGCGAC -> CCAGGACGACCCCGCGACA
TAGCACGAATTTTATACAA -> AGCACGAATTTTATACAAG
GCCACTGAAAGGTTAGCAA -> CCACTGAAAGGTTAGCAAC
TAATCAATTACGCCAGAAT -> AATCAATTACGCCAGAATT
CGTCCCTGGCCTCCGAACA -> GTCCCTGGCCTCCGAACAG
GTCATACAATGATCCCCTC -> TCATACAATGATCCCCTCC
TGTCCTGGGAGAGGCTTAA -> GTCCTGGGAGAGGCTTAAT
TCAGTGGGTAAGGCCAAGG -> CAGTGGGTAAGGCCAAGGA,CAGTGGGTAAGGCCAAGGA
GGCCAAGGACGCACCCCGT -> GCCAAGGACGCACCCCGTA
TACGTACGGATCTGCTCTC -> ACGTACGGATCTGCTCTCC
TCTGAAAACTAATGTCCAC -> CTGAAAACTAATGTCCACA
GCGGGCTATCTGAAAACTA -> CGGGCTATCTGAAAACTAA
CTAGAAGTAGTATTATTAA -> TAGAAGTAGTATTATTAAA
AAATCGGGACACAAGTGCG -> AATCGGGACACAAGTGCGA
GAGGGCAGATTCAGTACCG -> AGGGCAGATTCAGTACCGC
ATCGGGACACAAGTGCGAC -> TCGGGACACAAGTGCGACC
GTAAGCGTCCCGCTGAAGG -> TAAGCGTCCCGCTGAAGGA
ACGCACCCCGTATGGCTCA -> CGCACCCCGTATGGCTCAG
TTTTATACAAGTACCGTGG -> TTTATACAAGTACCGTGGA
GCTTATGTACGGCAGTACG -> CTTATGTACGGCAGTACGT
ACACGTGTAGTGCTAGCCT -> CACGTGTAGTGCTAGCCTG
AATGAGGGCTGCCGAGGCT -> ATGAGGGCTGCCGAGGCTA
TTCAGATGGCCATGCGGTA -> TCAGATGGCCATGCGGTAT
TTGAGGCCCAGAATGAGGG -> TGAGGCCCAGAATGAGGGC
GGTATCGGTACTGGGAAGG -> GTATCGGTACTGGGAAGGA
TGGTGGCCTTGCAGTAGCG -> GGTGGCCTTGCAGTAGCGG
AAGGCCAAGGACGCACCCC -> AGGCCAAGGACGCACCCCG
ATTCCGGCAGAGCCACGCG -> TTCCGGCAGAGCCACGCGA
CCTCTCAATGCGCTAGCCG -> CTCTCAATGCGCTAGCCGG
GTTTTTTGAGCCCCTCTCA -> TTTTTTGAGCCCCTCTCAA
GCGACCCATGAATATAAGC -> CGACCCATGAATATAAGCC
TTCTGCGCTCGGATGTGTT -> TCTGCGCTCGGATGTGTTA
TATTCCGGCAGAGCCACGC -> ATTCCGGCAGAGCCACGCG
CGTCACACCCCCGTCTTAC -> GTCACACCCCCGTCTTACA
TTGCGTGTCACATTCGAAG -> TGCGTGTCACATTCGAAGT
GGAAATGTAATGAATGTAA -> GAAATGTAATGAATGTAAG
TTGGCCCGCCACCCCCGGT -> TGGCCCGCCACCCCCGGTT
GCAGTACGTCCCTGGCCTC -> CAGTACGTCCCTGGCCTCC
CCCGCGTTCAGAGATGTCG -> CCGCGTTCAGAGATGTCGA
CAAATAAACACCACTAGTA -> AAATAAACACCACTAGTAC
TGGCAAATTATCCCGACAC -> GGCAAATTATCCCGACACT
TAAGGCCAAGGACGCACCC -> AAGGCCAAGGACGCACCCC
AGTCTGGCTGGAAATGTAA -> GTCTGGCTGGAAATGTAAT
TGAAGGACAGTACTTAAAT -> GAAGGACAGTACTTAAATA
TTTATACAAGTACCGTGGA -> TTATACAAGTACCGTGGAG
ACTAATGTCCACAACCAGG -> CTAATGTCCACAACCAGGA
CCATGAATATAAGCCACGC -> CATGAATATAAGCCACGCG
AGTTTCTTCATTAAAGGGA -> GTTTCTTCATTAAAGGGAA
GTAATACCGCCAATAAGTC -> TAATACCGCCAATAAGTCT
ATCTTGGTAGCCACGCGAG -> TCTTGGTAGCCACGCGAGC
TTCAGTACCGCTGCCGAGG -> TCAGTACCGCTGCCGAGGT
TCCCTGGCCTCCGAACAGG -> CCCTGGCCTCCGAACAGGA
TGGTATGGGTAGGGGAACC -> GGTATGGGTAGGGGAACCC
CCCTGGCCTCCGAACAGGA -> CCTGGCCTCCGAACAGGAA
CAGCAGTAAGTGCCACTCC -> AGCAGTAAGTGCCACTCCG
GATGGTCATGGGTAAGGCC -> ATGGTCATGGGTAAGGCCA
CGTGAGTCTTTGTGGTACA -> GTGAGTCTTTGTGGTACAT
CGGATCTGCTCTCCCAGGA -> GGATCTGCTCTCCCAGGAG
TCGTATCTTGGTAGCCACG -> CGTATCTTGGTAGCCACGC
TGGGTAAGGCCAAGGACGC -> GGGTAAGGCCAAGGACGCT,GGGTAAGGCCAAGGACGCA,GGGTAAGGCCAAGGACGCA,GGGTAAGGCCAAGGACGCT
CTCCACTGAACTCTTCGAA -> TCCACTGAACTCTTCGAAG
CACGCGCGGTACCGTACTC -> ACGCGCGGTACCGTACTCT
CACCATTTCACTTGATGTC -> ACCATTTCACTTGATGTCT
GCCGGGACGTGGCATGAAC -> CCGGGACGTGGCATGAACA
GTACCGTGGAGAGGTATGA -> TACCGTGGAGAGGTATGAG
GAAACACGCGCGGTACCGT -> AAACACGCGCGGTACCGTA
TGGGAAGGACCCACCACAG -> GGGAAGGACCCACCACAGC
CCCCGTATGGCTCAGCCCG -> CCCGTATGGCTCAGCCCGT
TTGCACGCGCGGTTTTTTG -> TGCACGCGCGGTTTTTTGA
ATAGCCGCTGACAGAGAAA -> TAGCCGCTGACAGAGAAAT
ATAGTACTCGCGATTCGAG -> TAGTACTCGCGATTCGAGG
CCTGCGGAGATTAGGTTAC -> CTGCGGAGATTAGGTTACA
CTTCGAAGATCGTATTTAG -> TTCGAAGATCGTATTTAGT
CGTGTCACATTCGAAGTTT -> GTGTCACATTCGAAGTTTC
TTTGTCGCCGTAAACTTGC -> TTGTCGCCGTAAACTTGCG
TTATACAAGTACCGTGGAG -> TATACAAGTACCGTGGAGA
AGAGATTCTGCAATACGTG -> GAGATTCTGCAATACGTGC
TGAACATTTATAACCCCGA -> GAACATTTATAACCCCGAA
CGGTGGCAAATTATCCCGA -> GGTGGCAAATTATCCCGAC
GGGTGAGAACTTGGCTTAA -> GGTGAGAACTTGGCTTAAA
GGATCGCATGTGATGCTGG -> GATCGCATGTGATGCTGGT
CTGGGTAAGGCCAAGGACG -> TGGGTAAGGCCAAGGACGC
TTACACCATCTTAGATTTC -> TACACCATCTTAGATTTCC
TTCAGAGATGTCGAGAAAC -> TCAGAGATGTCGAGAAACA
TCCGCGTGTTTGCTTATGT -> CCGCGTGTTTGCTTATGTA
CTTTCAGATGGCCATGCGG -> TTTCAGATGGCCATGCGGT
GCGTCATAATTTCGTGCAT -> CGTCATAATTTCGTGCATG
GCGGCAACCTACACGTGTA -> CGGCAACCTACACGTGTAG
GCTATCTGAAAACTAATGT -> CTATCTGAAAACTAATGTC
CAAGGACGCTTAGCCAGCG -> AAGGACGCTTAGCCAGCGT
TTGAATTGTTTAATCAATT -> TGAATTGTTTAATCAATTA
CCACGCGAGCTGGGAGCCA -> CACGCGAGCTGGGAGCCAA
AGCTGGGAGTAAGATGGTC -> GCTGGGAGTAAGATGGTCA
GATCGTATTTAGTTGATTC -> ATCGTATTTAGTTGATTCT
ATCGTGAGTCTTTGTGGTA -> TCGTGAGTCTTTGTGGTAC
GCCGAGGCTAGCCACTGAA -> CCGAGGCTAGCCACTGAAA
TGTACGGCAGTACGTCCCT -> GTACGGCAGTACGTCCCTG
AAGGACGCTATCCCTGCGC -> AGGACGCTATCCCTGCGCC
CTGCGGGCTATCTGAAAAC -> TGCGGGCTATCTGAAAACT
GTGCCACTCCGGCGAGCCC -> TGCCACTCCGGCGAGCCCC
AGCCAAATTAGTCTGGGTA -> GCCAAATTAGTCTGGGTAA
ACGACCCCGCGACAGGGAC -> CGACCCCGCGACAGGGACG
AAGATCGTATTTAGTTGAT -> AGATCGTATTTAGTTGATT
GAATTTTATACAAGTACCG -> AATTTTATACAAGTACCGT
GGCTCAGCCCGTAACGCAT -> GCTCAGCCCGTAACGCATG
TGGATCTTTCTCTGGTGCA -> GGATCTTTCTCTGGTGCAG
CCCCCGTCTTACAATTGGT -> CCCCGTCTTACAATTGGTA
GGGGCCTATCGTATCTTGG -> GGGCCTATCGTATCTTGGT
ACACTTGTCGGGCTGTAGC -> CACTTGTCGGGCTGTAGCA
AGACCACGCCCTGTTGACC -> GACCACGCCCTGTTGACCG
GATTTCCTATCTGCCACTT -> ATTTCCTATCTGCCACTTC
GCCAAATTAGTCTGGGTAA -> CCAAATTAGTCTGGGTAAG
TAGCCACTGAAAGGTTAGC -> AGCCACTGAAAGGTTAGCA
CAAGTACCGTGGAGAGGTA -> AAGTACCGTGGAGAGGTAT
TCGAAGATCGTATTTAGTT -> CGAAGATCGTATTTAGTTG
TGTAGTGCTAGCCTGACTC -> GTAGTGCTAGCCTGACTCC
CTTGCAGTAGCGGTGGCAA -> TTGCAGTAGCGGTGGCAAA
GAGAGGCTTAATTTGGGAT -> AGAGGCTTAATTTGGGATT
AAGGCCAAGGACGCTTAGC -> AGGCCAAGGACGCTTAGCC
GCGGATCGCATGTGATGCT -> CGGATCGCATGTGATGCTG
CGCACCCCGTATGGCTCAG -> GCACCCCGTATGGCTCAGC
ATGTAAGCGTCCCGCTGAA -> TGTAAGCGTCCCGCTGAAG
CTGGTGCAGTAAACACAGC -> TGGTGCAGTAAACACAGCC
CGGCGGGAGGAAATCGGGA -> GGCGGGAGGAAATCGGGAC
TCATTAAAGGGAAGATCTA -> CATTAAAGGGAAGATCTAA
ATAATCTACTCTTTCAGAT -> TAATCTACTCTTTCAGATG
TACAATCACAACTGAAGGG -> ACAATCACAACTGAAGGGG
CAGAATTTTAATCCCGGTT -> AGAATTTTAATCCCGGTTT
TCAAGACGTAGTGCTGATG -> CAAGACGTAGTGCTGATGA
TGAGGCCCAGAATGAGGGC -> GAGGCCCAGAATGAGGGCT
TGTGTTAGACAAATAGCTG -> GTGTTAGACAAATAGCTGT
AAGCGTCCCGCTGAAGGAC -> AGCGTCCCGCTGAAGGACA
ACGAATTTTATACAAGTAC -> CGAATTTTATACAAGTACC
GCTGGGAGATTCCCTTCAG -> CTGGGAGATTCCCTTCAGT
ACACTTCCACAAACCGATC -> CACTTCCACAAACCGATCC
CGAGCTGGGAGATTCCCTT -> GAGCTGGGAGATTCCCTTC
TTTTTTGAGCCCCTCTCAA -> TTTTTGAGCCCCTCTCAAT
AAACTAATGTCCACAACCA -> AACTAATGTCCACAACCAG
GCTGTAGCACGAATTTTAT -> CTGTAGCACGAATTTTATA
GCACGAATTTTATACAAGT -> CACGAATTTTATACAAGTA
ATGGTATGGGTAGGGGAAC -> TGGTATGGGTAGGGGAACC
TTAGGCGGATCGCATGTGA -> TAGGCGGATCGCATGTGAT
TTTGTGAGTTCTGCGCTCG -> TTGTGAGTTCTGCGCTCGG
CCCGAGGGCAGATTCAGTA -> CCGAGGGCAGATTCAGTAC
GCCCGCCACCCCCGGTTTA -> CCCGCCACCCCCGGTTTAC
ATGTCCACAACCAGGACGA -> TGTCCACAACCAGGACGAC
TTGTTTAATCAATTACGCC -> TGTTTAATCAATTACGCCA
TGTTAGACAAATAGCTGTA -> GTTAGACAAATAGCTGTAG
GTCATTTATTTATGGATCT -> TCATTTATTTATGGATCTT
CAACTGAAGGGGGCCTATC -> AACTGAAGGGGGCCTATCG
CCCGCGACAGGGACGCAAA -> CCGCGACAGGGACGCAAAC
CACATTCGAAGTTTCTTCA -> ACATTCGAAGTTTCTTCAT
CACTAATTGTCCTGGGAGA -> ACTAATTGTCCTGGGAGAG
CCTATCGTATCTTGGTAGC -> CTATCGTATCTTGGTAGCC
CGTGCATGTTTAGGCGGAT -> GTGCATGTTTAGGCGGATC
GAAGGACCCACCACAGCTT -> AAGGACCCACCACAGCTTG
GACGCTTAGCCAGCGTCGG -> ACGCTTAGCCAGCGTCGGA
TTGGTAATACCGCCAATAA -> TGGTAATACCGCCAATAAG
GCGCGGTACCGTACTCTCG -> CGCGGTACCGTACTCTCGG
CCGGAAGAGCAGTCGCAAG -> CGGAAGAGCAGTCGCAAGA
CGCATGGAGAAATGCCGTG -> GCATGGAGAAATGCCGTGT
AATATAATTGCCGATTAAT -> ATATAATTGCCGATTAATG
TCTCCGCGTGTTTGCTTAT -> CTCCGCGTGTTTGCTTATG
CGCATGTGATGCTGGTGGC -> GCATGTGATGCTGGTGGCC
CCCGGTTTGAGGCCCAGAA -> CCGGTTTGAGGCCCAGAAT
GCGAGCTGGGAGATTCCCT -> CGAGCTGGGAGATTCCCTT
GTACGGATCTGCTCTCCCA -> TACGGATCTGCTCTCCCAG
CCATGCACACCGTAGCCCA -> CATGCACACCGTAGCCCAC
GCCACTCCGGCGAGCCCCC -> CCACTCCGGCGAGCCCCCA
GAATCCGGCGGGAGGAAAT -> AATCCGGCGGGAGGAAATC
AATGGAGGAATGGCAAATA -> ATGGAGGAATGGCAAATAA
TCCCGACACTTCCACAAAC -> CCCGACACTTCCACAAACC
TCCGGCGGGAGGAAATCGG -> CCGGCGGGAGGAAATCGGG
ATTTTAATCCCGGTTTGAG -> TTTTAATCCCGGTTTGAGG
AGCCCGTAACGCATGGAGA -> GCCCGTAACGCATGGAGAA
ACCCCGCGACAGGGACGCA -> CCCCGCGACAGGGACGCAA
ATGAGGGCTGCCGAGGCTA -> TGAGGGCTGCCGAGGCTAG
AGTAGTCTGGCTGGAAATG -> GTAGTCTGGCTGGAAATGT
AATACCGCCAATAAGTCTC -> ATACCGCCAATAAGTCTCC
ATGAACATTTATAACCCCG -> TGAACATTTATAACCCCGA
ACGTGTAGTGCTAGCCTGA -> CGTGTAGTGCTAGCCTGAC
TCATGTAAAACTGCTTGAA -> CATGTAAAACTGCTTGAAG
AAGGGGGCCTATCGTATCT -> AGGGGGCCTATCGTATCTT
CGCTTAGCCAGCGTCGGAC -> GCTTAGCCAGCGTCGGACT
GGGTAGGGGAACCCGGTCC -> GGTAGGGGAACCCGGTCCA
CAATAAGTCTCCCGAAAAG -> AATAAGTCTCCCGAAAAGC
TTTAGTCGACTGGATCCTC -> TTAGTCGACTGGATCCTCT
TCCCAGGCCCCTTAAGCCC -> CCCAGGCCCCTTAAGCCCG
CTTTCTCTGGTGCAGTAAA -> TTTCTCTGGTGCAGTAAAC
GCCCGCTGTGCATACTCAA -> CCCGCTGTGCATACTCAAC
TAGCCCACTTTTACAGGGG -> AGCCCACTTTTACAGGGGC
ATTAAAGGGAAGATCTAAG -> TTAAAGGGAAGATCTAAGA
ATTCAGTACCGCTGCCGAG -> TTCAGTACCGCTGCCGAGG
CTCGGATGTGTTAGACAAA -> TCGGATGTGTTAGACAAAT
GGCCCCTTAAGCCCGCTGT -> GCCCCTTAAGCCCGCTGTG
ACAAACCGATCCAGGACCC -> CAAACCGATCCAGGACCCT
CTTGGGACTGCGGGCTATC -> TTGGGACTGCGGGCTATCT
TGCGTCATAATTTCGTGCA -> GCGTCATAATTTCGTGCAT
TTGATGCACCATTTCACTT -> TGATGCACCATTTCACTTG
TGCGTCTGAAACAGGTATT -> GCGTCTGAAACAGGTATTC
CTCGGTTTGAACCGTGAAT -> TCGGTTTGAACCGTGAATC
TCTCTGGTGCAGTAAACAC -> CTCTGGTGCAGTAAACACA
TTAGCAACAACCGTGCCTG -> TAGCAACAACCGTGCCTGT
GTATGGGTAGGGGAACCCG -> TATGGGTAGGGGAACCCGG
GTGTCACATTCGAAGTTTC -> TGTCACATTCGAAGTTTCT
GCTTAATTTGGGATTATCC -> CTTAATTTGGGATTATCCC
GACGTAGTGCTGATGAATA -> ACGTAGTGCTGATGAATAA
GACTTTCTCGGCGAGGGAT -> ACTTTCTCGGCGAGGGATA
TAATGAATGTAAGCGTCCC -> AATGAATGTAAGCGTCCCG
TATCATGTAAAACTGCTTG -> ATCATGTAAAACTGCTTGA
ACTTTTACAGGGGCCTTTC -> CTTTTACAGGGGCCTTTCC
TTGTGGTACATGGCCACTA -> TGTGGTACATGGCCACTAA
AAATACGTACGGATCTGCT -> AATACGTACGGATCTGCTC
CCCCGCGACAGGGACGCAA -> CCCGCGACAGGGACGCAAA
GTTTGAACCGTGAATCCGG -> TTTGAACCGTGAATCCGGC
TTAATTTGGGATTATCCCA -> TAATTTGGGATTATCCCAG
CATACTCAACCAGAGATTC -> ATACTCAACCAGAGATTCT
GGTCCAATAATCTACTCTT -> GTCCAATAATCTACTCTTT
GAAATGGTATGGGTAGGGG -> AAATGGTATGGGTAGGGGA
CTTTCTCGGCGAGGGATAA -> TTTCTCGGCGAGGGATAAC
GCCACTAATTGTCCTGGGA -> CCACTAATTGTCCTGGGAG
GTTGATTCTGGCCTCTCTC -> TTGATTCTGGCCTCTCTCC
ACTCACTCCATTTCAAGAC -> CTCACTCCATTTCAAGACG
TTTGAGGCGAGTACTTGAA -> TTGAGGCGAGTACTTGAAT
ACCCATGAATATAAGCCAC -> CCCATGAATATAAGCCACG
TCGTTTAGTCGACTGGATC -> CGTTTAGTCGACTGGATCC
GAGGCCCAGAATGAGGGCT -> AGGCCCAGAATGAGGGCTG
CCTGACTCCCTTTGTCGCC -> CTGACTCCCTTTGTCGCCG
AGAAGTAGTATTATTAAAG -> GAAGTAGTATTATTAAAGT
TGTGATGCTGGTGGCCTTG -> GTGATGCTGGTGGCCTTGC
ATGTATATCATGTAAAACT -> TGTATATCATGTAAAACTG
CGGACTTTCTCGGCGAGGG -> GGACTTTCTCGGCGAGGGA
CTAATGTCCACAACCAGGA -> TAATGTCCACAACCAGGAC
CACAGCTTGGGACTGCGGG -> ACAGCTTGGGACTGCGGGC
ATCGTATCTTGGTAGCCAC -> TCGTATCTTGGTAGCCACG
CCACCACAGCTTGGGACTG -> CACCACAGCTTGGGACTGC
AACCGTGCCTGTCCTATAC -> ACCGTGCCTGTCCTATACC
GGACGCAAACGGAATTCTC -> GACGCAAACGGAATTCTCG
ACCAGGGCCTACAATCACA -> CCAGGGCCTACAATCACAA
GTCACACCCCCGTCTTACA -> TCACACCCCCGTCTTACAA
GTATTTAGTTGATTCTGGC -> TATTTAGTTGATTCTGGCC
CACGCGAGCTGGGAGCCAA -> ACGCGAGCTGGGAGCCAAA
CCGTGCCTGTCCTATACCC -> CGTGCCTGTCCTATACCCA
ACCAGAGATTCTGCAATAC -> CCAGAGATTCTGCAATACG
GTGAGTCTTTGTGGTACAT -> TGAGTCTTTGTGGTACATG
GAATAAGCTAGAGACCACT -> AATAAGCTAGAGACCACTA
TCGGCGAGGGATAACGCTC -> CGGCGAGGGATAACGCTCC
GCTAGCCTGACTCCCTTTG -> CTAGCCTGACTCCCTTTGT
CGGCAGTACGTCCCTGGCC -> GGCAGTACGTCCCTGGCCT
GCCTACAATCACAACTGAA -> CCTACAATCACAACTGAAG
CAACCTACACGTGTAGTGC -> AACCTACACGTGTAGTGCT
CACTTCCACAAACCGATCC -> ACTTCCACAAACCGATCCA
AATCCCGGTTTGAGGCCCA -> ATCCCGGTTTGAGGCCCAG
CCGCGACAGGGACGCAAAC -> CGCGACAGGGACGCAAACG
TTCCTATCTGCCACTTCCA -> TCCTATCTGCCACTTCCAG
AAACTGCTTGAAGAAATGG -> AACTGCTTGAAGAAATGGT
GGCTTAAACTTTGATAGCC -> GCTTAAACTTTGATAGCCG
CAAGGACGCTATCCCTGCG -> AAGGACGCTATCCCTGCGC
CTGCGGAGATTAGGTTACA -> TGCGGAGATTAGGTTACAC
CCTGAGGGAATCTAATATA -> CTGAGGGAATCTAATATAA
TGCACCATTTCACTTGATG -> GCACCATTTCACTTGATGT
AGTACCAGGGCCTACAATC -> GTACCAGGGCCTACAATCA
AAATGCCGTGTGATTCTTA -> AATGCCGTGTGATTCTTAC
ATCCCAGGCCCCTTAAGCC -> TCCCAGGCCCCTTAAGCCC
AGCCAGCGTCGGACTTTCT -> GCCAGCGTCGGACTTTCTC
AGGACGACCCCGCGACAGG -> GGACGACCCCGCGACAGGG
GGCCGGAAGAGCAGTCGCA -> GCCGGAAGAGCAGTCGCAA
GTCGCAGCAGTAAGTGCCA -> TCGCAGCAGTAAGTGCCAC
GATGAATAAGCTAGAGACC -> ATGAATAAGCTAGAGACCA
ACAGGGGCCTTTCCTGAGG -> CAGGGGCCTTTCCTGAGGG
GAATGGCAAATAAACACCA -> AATGGCAAATAAACACCAC
TACCGTGGAGAGGTATGAG -> ACCGTGGAGAGGTATGAGC
TACGGATCTGCTCTCCCAG -> ACGGATCTGCTCTCCCAGG
GGACGCTTAGCCAGCGTCG -> GACGCTTAGCCAGCGTCGG
ACCCATGCACACCGTAGCC -> CCCATGCACACCGTAGCCC
ACGAACACTTGTCGGGCTG -> CGAACACTTGTCGGGCTGT
GATTCTGCAATACGTGCGT -> ATTCTGCAATACGTGCGTC
AACTTTGATAGCCGCTGAC -> ACTTTGATAGCCGCTGACA
CACAACCAGGACGACCCCG -> ACAACCAGGACGACCCCGC
CAAATAGCTGTAGTTCAGG -> AAATAGCTGTAGTTCAGGC
GTCCACAACCAGGACGACC -> TCCACAACCAGGACGACCC
TATCTGCCACTTCCAGCTG -> ATCTGCCACTTCCAGCTGG
GGCGAGCCCCCAAGTATCT -> GCGAGCCCCCAAGTATCTG
GTTTACAAATCGTGAGTCT -> TTTACAAATCGTGAGTCTT
CCGAGGTCTAAGTAGTCTG -> CGAGGTCTAAGTAGTCTGG
GTTGACCGAAAGTAAGTAT -> TTGACCGAAAGTAAGTATG
CAGAATGAGGGCTGCCGAG -> AGAATGAGGGCTGCCGAGG
CCGGTTTACAAATCGTGAG -> CGGTTTACAAATCGTGAGT
TGGTACATGGCCACTAATT -> GGTACATGGCCACTAATTG
TCACACCCCCGTCTTACAA -> CACACCCCCGTCTTACAAT
CAGATTCAGTACCGCTGCC -> AGATTCAGTACCGCTGCCG
CTCACTCCATTTCAAGACG -> TCACTCCATTTCAAGACGT
TATAACCCCGAAGATGCGC -> ATAACCCCGAAGATGCGCG
GCAAATTATCCCGACACTT -> CAAATTATCCCGACACTTC
GCTGTGCATACTCAACCAG -> CTGTGCATACTCAACCAGA
CTTATGTACGGCAGTACGT -> TTATGTACGGCAGTACGTC
CTTAAATACGTACGGATCT -> TTAAATACGTACGGATCTG
GGCCTCCGAACAGGAATGT -> GCCTCCGAACAGGAATGTC
TATACAAGTACCGTGGAGA -> ATACAAGTACCGTGGAGAG
AAGATGGTCATGGGTAAGG -> AGATGGTCATGGGTAAGGC
TACTGGGAAGGACCCACCA -> ACTGGGAAGGACCCACCAC
CCGCGTTCAGAGATGTCGA -> CGCGTTCAGAGATGTCGAG
GCGTCGGACTTTCTCGGCG -> CGTCGGACTTTCTCGGCGA
CTTGAATTGTTTAATCAAT -> TTGAATTGTTTAATCAATT
TACGCCAGAATTTTAATCC -> ACGCCAGAATTTTAATCCC
CATGTGATGCTGGTGGCCT -> ATGTGATGCTGGTGGCCTT
AGCGGTGGCAAATTATCCC -> GCGGTGGCAAATTATCCCG
CAAGTATCTGTGCTGCGTC -> AAGTATCTGTGCTGCGTCA
ATAAGCTAGAGACCACTAA -> TAAGCTAGAGACCACTAAT
CACCACTAGTACTCGCTGC -> ACCACTAGTACTCGCTGCC
AGTACTTAAATACGTACGG -> GTACTTAAATACGTACGGA
TTGCTTATGTACGGCAGTA -> TGCTTATGTACGGCAGTAC
TCTTCGAAGATCGTATTTA -> CTTCGAAGATCGTATTTAG
TTGTCCTGGGAGAGGCTTA -> TGTCCTGGGAGAGGCTTAA
TAATTTGGGATTATCCCAG -> AATTTGGGATTATCCCAGG
CAGGCCCCTTAAGCCCGCT -> AGGCCCCTTAAGCCCGCTG
TGCCACTCCGGCGAGCCCC -> GCCACTCCGGCGAGCCCCC
CTGGGGTGAGAACTTGGCT -> TGGGGTGAGAACTTGGCTT
GCCTCCGAACAGGAATGTC -> CCTCCGAACAGGAATGTCG
GCGTTCAGAGATGTCGAGA -> CGTTCAGAGATGTCGAGAA
CCAGCGTCGGACTTTCTCG -> CAGCGTCGGACTTTCTCGG
TTGGGACTGCGGGCTATCT -> TGGGACTGCGGGCTATCTG
ACTTCCACAAACCGATCCA -> CTTCCACAAACCGATCCAG
GTACGGTATCCCATTGATG -> TACGGTATCCCATTGATGC
TACTCAACCAGAGATTCTG -> ACTCAACCAGAGATTCTGC
AAACCGATCCAGGACCCTA -> AACCGATCCAGGACCCTAT
TGGCTGGAAATGTAATGAA -> GGCTGGAAATGTAATGAAT
CCTGGCCTCCGAACAGGAA -> CTGGCCTCCGAACAGGAAT
GAAGTAGTATTATTAAAGT -> AAGTAGTATTATTAAAGTC
GACCCATGAATATAAGCCA -> ACCCATGAATATAAGCCAC
GGATAACGCTCCACTGAAC -> GATAACGCTCCACTGAACT
TGTTTGCTTATGTACGGCA -> GTTTGCTTATGTACGGCAG
CCAAATTAGTCTGGGTAAG -> CAAATTAGTCTGGGTAAGG
GGGTAAGGCCAAGGACGCA -> GGTAAGGCCAAGGACGCAG,GGTAAGGCCAAGGACGCAC
GTACCAGGGCCTACAATCA -> TACCAGGGCCTACAATCAC
CGGATCGCATGTGATGCTG -> GGATCGCATGTGATGCTGG
TCTGTGCTGCGTCATAATT -> CTGTGCTGCGTCATAATTT
GGCAGAGCCACGCGAGCTG -> GCAGAGCCACGCGAGCTGG
GGTATCCCATTGATGCACC -> GTATCCCATTGATGCACCA
AATATAAGCCACGCGAGCT -> ATATAAGCCACGCGAGCTG
AATCGGGACACAAGTGCGA -> ATCGGGACACAAGTGCGAC
GACCCACCACAGCTTGGGA -> ACCCACCACAGCTTGGGAC
GCAGAGCCACGCGAGCTGG -> CAGAGCCACGCGAGCTGGG
AGTAAGATGGTCATGGGTA -> GTAAGATGGTCATGGGTAA
GTATGAGCTTGCACGCGCG -> TATGAGCTTGCACGCGCGG
TATCGGTACTGGGAAGGAC -> ATCGGTACTGGGAAGGACC
GGGGAACCCGGTCCAATAA -> GGGAACCCGGTCCAATAAT
GAAGATCTAAGACTCACTC -> AAGATCTAAGACTCACTCC
CGGGAGGAAATCGGGACAC -> GGGAGGAAATCGGGACACA
CAGGTATTCCGGCAGAGCC -> AGGTATTCCGGCAGAGCCA
GTAAGGCCAAGGACGCACC -> TAAGGCCAAGGACGCACCC
CCTTTGTCGCCGTAAACTT -> CTTTGTCGCCGTAAACTTG
GCACCCCGTATGGCTCAGC -> CACCCCGTATGGCTCAGCC
ATGACTAACCGTCATTTAT -> TGACTAACCGTCATTTATT
ATTCTCGCCGTAGTACCAG -> TTCTCGCCGTAGTACCAGG
CCACTGAAAGGTTAGCAAC -> CACTGAAAGGTTAGCAACA
AAGCCCGCTGTGCATACTC -> AGCCCGCTGTGCATACTCA
CTCTCAATGCGCTAGCCGG -> TCTCAATGCGCTAGCCGGG
CCGAACAACCCCGAGGGCA -> CGAACAACCCCGAGGGCAG
AAGTAGTATTATTAAAGTC -> AGTAGTATTATTAAAGTCG
ATATAAGCCACGCGAGCTG -> TATAAGCCACGCGAGCTGG
TGTTGACCGAAAGTAAGTA -> GTTGACCGAAAGTAAGTAT
TCTTGGTAGCCACGCGAGC -> CTTGGTAGCCACGCGAGCT
AGCGTCGGACTTTCTCGGC -> GCGTCGGACTTTCTCGGCG
TCTTACGAACACTTGTCGG -> CTTACGAACACTTGTCGGG
ACCACGCCCTGTTGACCGA -> CCACGCCCTGTTGACCGAA
AGGACGCAGGCATTTTAGA -> GGACGCAGGCATTTTAGAC
TAGTCTGGCTGGAAATGTA -> AGTCTGGCTGGAAATGTAA
AATTATCCCGACACTTCCA -> ATTATCCCGACACTTCCAC
TGTAGTTCAGGCTAGAAGT -> GTAGTTCAGGCTAGAAGTA
AAATTAGTCTGGGTAAGGC -> AATTAGTCTGGGTAAGGCC
ACTGAAAGGTTAGCAACAA -> CTGAAAGGTTAGCAACAAC
TCTGGGTAAGGCCAAGGAC -> CTGGGTAAGGCCAAGGACG
GAATGTCGCAGCAGTAAGT -> AATGTCGCAGCAGTAAGTG
GTCGGGCTGTAGCACGAAT -> TCGGGCTGTAGCACGAATT
GGTATGAGCTTGCACGCGC -> GTATGAGCTTGCACGCGCG
ACAGTACTTAAATACGTAC -> CAGTACTTAAATACGTACG
GGACAGTACTTAAATACGT -> GACAGTACTTAAATACGTA
AGTAAGTGCCACTCCGGCG -> GTAAGTGCCACTCCGGCGA
AGTACCGTGGAGAGGTATG -> GTACCGTGGAGAGGTATGA
TCCCGCTGAAGGACAGTAC -> CCCGCTGAAGGACAGTACT
GAACTTGGCTTAAACTTTG -> AACTTGGCTTAAACTTTGA
CCCTTTGTCGCCGTAAACT -> CCTTTGTCGCCGTAAACTT
TGTGATTCTTACGAACACT -> GTGATTCTTACGAACACTT
AGTCGCAAGAATCGTCACA -> GTCGCAAGAATCGTCACAC
GGGCTGCCGAGGCTAGCCA -> GGCTGCCGAGGCTAGCCAC
GTCCTATACCCATGCACAC -> TCCTATACCCATGCACACC
TTCGAAGTTTCTTCATTAA -> TCGAAGTTTCTTCATTAAA
AAGGACGCACCCCGTATGG -> AGGACGCACCCCGTATGGC
CTCGCCGTAGTACCAGGGC -> TCGCCGTAGTACCAGGGCC
AGTACGTCCCTGGCCTCCG -> GTACGTCCCTGGCCTCCGA
CAACCAGAGATTCTGCAAT -> AACCAGAGATTCTGCAATA
ACTCTCGGACTTTGAGGCG -> CTCTCGGACTTTGAGGCGA
GTCGTTTAGTCGACTGGAT -> TCGTTTAGTCGACTGGATC
TCTCGGCGAGGGATAACGC -> CTCGGCGAGGGATAACGCT
CGCGACAGGGACGCAAACG -> GCGACAGGGACGCAAACGG
GGTGGCAAATTATCCCGAC -> GTGGCAAATTATCCCGACA
CTCCGAACAGGAATGTCGC -> TCCGAACAGGAATGTCGCA
TGTTGGCCCGCCACCCCCG -> GTTGGCCCGCCACCCCCGG
GCTGGGAGGTGACCGTCAG -> CTGGGAGGTGACCGTCAGT
GAGCCCCTCTCAATGCGCT -> AGCCCCTCTCAATGCGCTA
GTACTTAAATACGTACGGA -> TACTTAAATACGTACGGAT
CCCGTAACGCATGGAGAAA -> CCGTAACGCATGGAGAAAT
TACGAACACTTGTCGGGCT -> ACGAACACTTGTCGGGCTG
GCCAAGGACGCACCCCGTA -> CCAAGGACGCACCCCGTAT
GATTAATGGAGGAATGGCA -> ATTAATGGAGGAATGGCAA
CCATTGATGCACCATTTCA -> CATTGATGCACCATTTCAC
TCACTCCATTTCAAGACGT -> CACTCCATTTCAAGACGTA
CTCTGGTGCAGTAAACACA -> TCTGGTGCAGTAAACACAG
TCCCTGCGCCTGTCGAAGT -> CCCTGCGCCTGTCGAAGTC
AAAGTCGTTTAGTCGACTG -> AAGTCGTTTAGTCGACTGG
ACCGTGGAGAGGTATGAGC -> CCGTGGAGAGGTATGAGCT
TCCTGCGGAGATTAGGTTA -> CCTGCGGAGATTAGGTTAC
TACACCATCTTAGATTTCC -> ACACCATCTTAGATTTCCT
TGAAGAAATGGTATGGGTA -> GAAGAAATGGTATGGGTAG
GAGGTCTAAGTAGTCTGGC -> AGGTCTAAGTAGTCTGGCT
TGCTGCGTCATAATTTCGT -> GCTGCGTCATAATTTCGTG
GCTCGGATGTGTTAGACAA -> CTCGGATGTGTTAGACAAA
TGCCGAGGTCTAAGTAGTC -> GCCGAGGTCTAAGTAGTCT
ATCGCATGTGATGCTGGTG -> TCGCATGTGATGCTGGTGG
TACAGGGGCCTTTCCTGAG -> ACAGGGGCCTTTCCTGAGG
GGTGGCCTTGCAGTAGCGG -> GTGGCCTTGCAGTAGCGGT
GAGATGTCGAGAAACACGC -> AGATGTCGAGAAACACGCG
ACTCGCGATTCGAGGCCGG -> CTCGCGATTCGAGGCCGGA
CTGACGATAGTACTCGCGA -> TGACGATAGTACTCGCGAT
GCCGGAAGAGCAGTCGCAA -> CCGGAAGAGCAGTCGCAAG
CTGGGAGCCAAATTAGTCT -> TGGGAGCCAAATTAGTCTG
AGGACCCTATTCTAAATAT -> GGACCCTATTCTAAATATA
TACAAGTACCGTGGAGAGG -> ACAAGTACCGTGGAGAGGT
ATCCCTGCGCCTGTCGAAG -> TCCCTGCGCCTGTCGAAGT
TGGGAGCCAAATTAGTCTG -> GGGAGCCAAATTAGTCTGG
TCAGGCTAGAAGTAGTATT -> CAGGCTAGAAGTAGTATTA
TAGCCACGCGAGCTGGGAG -> AGCCACGCGAGCTGGGAGT
GACTGCGGGCTATCTGAAA -> ACTGCGGGCTATCTGAAAA
TAATATAATTGCCGATTAA -> AATATAATTGCCGATTAAT
ATCCAGGACCCTATTCTAA -> TCCAGGACCCTATTCTAAA
CCGAGGGCAGATTCAGTAC -> CGAGGGCAGATTCAGTACC
GTACCGCTGCCGAGGTCTA -> TACCGCTGCCGAGGTCTAA
ATGTGATGCTGGTGGCCTT -> TGTGATGCTGGTGGCCTTG
AGTGCTGATGAATAAGCTA -> GTGCTGATGAATAAGCTAG
GTGCGTCTGAAACAGGTAT -> TGCGTCTGAAACAGGTATT
TCGAAGTTTCTTCATTAAA -> CGAAGTTTCTTCATTAAAG
TGTCGCAGCAGTAAGTGCC -> GTCGCAGCAGTAAGTGCCA
TCTGCAATACGTGCGTCTG -> CTGCAATACGTGCGTCTGA
TGGCCTCCGAACAGGAATG -> GGCCTCCGAACAGGAATGT
TCTTCATTAAAGGGAAGAT -> CTTCATTAAAGGGAAGATC
CCGTATGGCTCAGCCCGTA -> CGTATGGCTCAGCCCGTAA
CCGCTGACAGAGAAATGAC -> CGCTGACAGAGAAATGACT
CGTCCCGCTGAAGGACAGT -> GTCCCGCTGAAGGACAGTA
TAGTGCTGATGAATAAGCT -> AGTGCTGATGAATAAGCTA
GAGATTCTGCAATACGTGC -> AGATTCTGCAATACGTGCG
TAAGCGTCCCGCTGAAGGA -> AAGCGTCCCGCTGAAGGAC
ATAAACACCACTAGTACTC -> TAAACACCACTAGTACTCG
ATCATGTAAAACTGCTTGA -> TCATGTAAAACTGCTTGAA
TTCATTAAAGGGAAGATCT -> TCATTAAAGGGAAGATCTA
TCGACTGGATCCTCTCGGT -> CGACTGGATCCTCTCGGTT
GATGGCCATGCGGTATCGG -> ATGGCCATGCGGTATCGGT
CCGGCGGGAGGAAATCGGG -> CGGCGGGAGGAAATCGGGA
CCTGTTGACCGAAAGTAAG -> CTGTTGACCGAAAGTAAGT
ACAAGTACCGTGGAGAGGT -> CAAGTACCGTGGAGAGGTA
CCCATTGATGCACCATTTC -> CCATTGATGCACCATTTCA
CCACTAATTGTCCTGGGAG -> CACTAATTGTCCTGGGAGA
TCTAATATAATTGCCGATT -> CTAATATAATTGCCGATTA
TTGTTGGCCCGCCACCCCC -> TGTTGGCCCGCCACCCCCG
GTACGTCCCTGGCCTCCGA -> TACGTCCCTGGCCTCCGAA
CGCAGCAGTAAGTGCCACT -> GCAGCAGTAAGTGCCACTC
CTGAAACAGGTATTCCGGC -> TGAAACAGGTATTCCGGCA
TGAATGTAAGCGTCCCGCT -> GAATGTAAGCGTCCCGCTG
TACATGGCCACTAATTGTC -> ACATGGCCACTAATTGTCC
ATACAATGATCCCCTCCTG -> TACAATGATCCCCTCCTGC
CCTATCTGCCACTTCCAGC -> CTATCTGCCACTTCCAGCT
TCTGCCACTTCCAGCTGGG -> CTGCCACTTCCAGCTGGGG
TGTTTAGGCGGATCGCATG -> GTTTAGGCGGATCGCATGT
ATCTTAGATTTCCTATCTG -> TCTTAGATTTCCTATCTGC
TCGTGAGTCTTTGTGGTAC -> CGTGAGTCTTTGTGGTACA
GCGCGGCAACCTACACGTG -> CGCGGCAACCTACACGTGT
CCCCCGGTTTACAAATCGT -> CCCCGGTTTACAAATCGTG
ACTCCGGCGAGCCCCCAAG -> CTCCGGCGAGCCCCCAAGT
CCAGCTGGGGTGAGAACTT -> CAGCTGGGGTGAGAACTTG
CCGCCACCCCCGGTTTACA -> CGCCACCCCCGGTTTACAA
GCTTGCACGCGCGGTTTTT -> CTTGCACGCGCGGTTTTTT
ACCGCCAATAAGTCTCCCG -> CCGCCAATAAGTCTCCCGA
ACTGAACTCTTCGAAGATC -> CTGAACTCTTCGAAGATCG
CTACACGTGTAGTGCTAGC -> TACACGTGTAGTGCTAGCC
GGACTTTCTCGGCGAGGGA -> GACTTTCTCGGCGAGGGAT
CGGCGAGCCCCCAAGTATC -> GGCGAGCCCCCAAGTATCT
TAGCCGGGACGTGGCATGA -> AGCCGGGACGTGGCATGAA
TCAGAGATGTCGAGAAACA -> CAGAGATGTCGAGAAACAC
ACTCCATTTCAAGACGTAG -> CTCCATTTCAAGACGTAGT
GGGAGATTCCCTTCAGTGG -> GGAGATTCCCTTCAGTGGG
AATAGCTGTAGTTCAGGCT -> ATAGCTGTAGTTCAGGCTA
TCGCGATTCGAGGCCGGAA -> CGCGATTCGAGGCCGGAAG
GTGCTGCGTCATAATTTCG -> TGCTGCGTCATAATTTCGT
GCCTTTCCTGAGGGAATCT -> CCTTTCCTGAGGGAATCTA
AGCTGGGGTGAGAACTTGG -> GCTGGGGTGAGAACTTGGC
AGATGGTCATGGGTAAGGC -> GATGGTCATGGGTAAGGCC
CCAGAGATTCTGCAATACG -> CAGAGATTCTGCAATACGT
CGGCAACCTACACGTGTAG -> GGCAACCTACACGTGTAGT
TGTGCTGCGTCATAATTTC -> GTGCTGCGTCATAATTTCG
ATCCTCTCGGTTTGAACCG -> TCCTCTCGGTTTGAACCGT
AACACCACTAGTACTCGCT -> ACACCACTAGTACTCGCTG
ACGCGAGCTGGGAGCCAAA -> CGCGAGCTGGGAGCCAAAT
CGTCATAATTTCGTGCATG -> GTCATAATTTCGTGCATGT
AGCTAGAGACCACTAATCC -> GCTAGAGACCACTAATCCG
CGGTTTGAGGCCCAGAATG -> GGTTTGAGGCCCAGAATGA
AATGTAATGAATGTAAGCG -> ATGTAATGAATGTAAGCGT
GTATGGCTCAGCCCGTAAC -> TATGGCTCAGCCCGTAACG
TTGAGCCCCTCTCAATGCG -> TGAGCCCCTCTCAATGCGC
CTAACCGTCATTTATTTAT -> TAACCGTCATTTATTTATG
CGACTGGATCCTCTCGGTT -> GACTGGATCCTCTCGGTTT
ATTTCAAGACGTAGTGCTG -> TTTCAAGACGTAGTGCTGA
CCTGGGAGAGGCTTAATTT -> CTGGGAGAGGCTTAATTTG
ATCTGCCACTTCCAGCTGG -> TCTGCCACTTCCAGCTGGG
ACGCCAGAATTTTAATCCC -> CGCCAGAATTTTAATCCCG
CCCCAAGTATCTGTGCTGC -> CCCAAGTATCTGTGCTGCG
CTCAGCCCGTAACGCATGG -> TCAGCCCGTAACGCATGGA
AATAAGCTAGAGACCACTA -> ATAAGCTAGAGACCACTAA
AGGGACGCAAACGGAATTC -> GGGACGCAAACGGAATTCT
TTTACAAATCGTGAGTCTT -> TTACAAATCGTGAGTCTTT
TGGCCTCTCTCCGCGTGTT -> GGCCTCTCTCCGCGTGTTT
TCACATTCGAAGTTTCTTC -> CACATTCGAAGTTTCTTCA
AACTTGCGTGTCACATTCG -> ACTTGCGTGTCACATTCGA
GGGCTGTAGCACGAATTTT -> GGCTGTAGCACGAATTTTA
ACAACCGTGCCTGTCCTAT -> CAACCGTGCCTGTCCTATA
AAAGTAAGTATGTATATCA -> AAGTAAGTATGTATATCAT
CCCCGAGGGCAGATTCAGT -> CCCGAGGGCAGATTCAGTA
ACACAAGTGCGACCCATGA -> CACAAGTGCGACCCATGAA
CGTCTTACAATTGGTAATA -> GTCTTACAATTGGTAATAC
CGCGCGGTACCGTACTCTC -> GCGCGGTACCGTACTCTCG
CTGCCGAACAACCCCGAGG -> TGCCGAACAACCCCGAGGG
CCACGCCCTGTTGACCGAA -> CACGCCCTGTTGACCGAAA
CGCTAGCCGGGACGTGGCA -> GCTAGCCGGGACGTGGCAT
TTATCCCAGGCCCCTTAAG -> TATCCCAGGCCCCTTAAGC
GAGGTATGAGCTTGCACGC -> AGGTATGAGCTTGCACGCG
GCATTTTAGACCACGCCCT -> CATTTTAGACCACGCCCTG
CTATCCCTGCGCCTGTCGA -> TATCCCTGCGCCTGTCGAA
TATCCCAGGCCCCTTAAGC -> ATCCCAGGCCCCTTAAGCC
ACAGCTTGGGACTGCGGGC -> CAGCTTGGGACTGCGGGCT
ATTATCCCAGGCCCCTTAA -> TTATCCCAGGCCCCTTAAG
CCGTCAGTGGGTAAGGCCA -> CGTCAGTGGGTAAGGCCAA
GAGGGAATCTAATATAATT -> AGGGAATCTAATATAATTG
GGGAGGAAATCGGGACACA -> GGAGGAAATCGGGACACAA
GATTCTGGCCTCTCTCCGC -> ATTCTGGCCTCTCTCCGCG
CCACAAACCGATCCAGGAC -> CACAAACCGATCCAGGACC
ATACTCAACCAGAGATTCT -> TACTCAACCAGAGATTCTG
GTTTGAGGCCCAGAATGAG -> TTTGAGGCCCAGAATGAGG
CCACTCCGGCGAGCCCCCA -> CACTCCGGCGAGCCCCCAA
TAATTGCCGATTAATGGAG -> AATTGCCGATTAATGGAGG
GAGCTGGGAGGTGACCGTC -> AGCTGGGAGGTGACCGTCA
GACCCTATTCTAAATATAG -> ACCCTATTCTAAATATAGC
TACGTCCCTGGCCTCCGAA -> ACGTCCCTGGCCTCCGAAC
ACTCTTTCAGATGGCCATG -> CTCTTTCAGATGGCCATGC
GCGTCTGAAACAGGTATTC -> CGTCTGAAACAGGTATTCC
CAGAGCCACGCGAGCTGGG -> AGAGCCACGCGAGCTGGGA
TAAGCCCGCTGTGCATACT -> AAGCCCGCTGTGCATACTC
AGATTCAGTACCGCTGCCG -> GATTCAGTACCGCTGCCGA
TGCACGCGCGGTTTTTTGA -> GCACGCGCGGTTTTTTGAG
CCTGTCGAAGTCATACAAT -> CTGTCGAAGTCATACAATG
GCCACCCCCGGTTTACAAA -> CCACCCCCGGTTTACAAAT
TCCCGAAAAGCCCGCGTTC -> CCCGAAAAGCCCGCGTTCA
CTGGATCCTCTCGGTTTGA -> TGGATCCTCTCGGTTTGAA
AAGTCATACAATGATCCCC -> AGTCATACAATGATCCCCT
CATTTCAAGACGTAGTGCT -> ATTTCAAGACGTAGTGCTG
CTATCTGCCACTTCCAGCT -> TATCTGCCACTTCCAGCTG
TGCCGTGTGATTCTTACGA -> GCCGTGTGATTCTTACGAA
TTTGAGGCCCAGAATGAGG -> TTGAGGCCCAGAATGAGGG
GAACCGTGAATCCGGCGGG -> AACCGTGAATCCGGCGGGA
AATTTTATACAAGTACCGT -> ATTTTATACAAGTACCGTG
GAATCTAATATAATTGCCG -> AATCTAATATAATTGCCGA
TATCCCATTGATGCACCAT -> ATCCCATTGATGCACCATT
TCACTTGATGTCTCATCCA -> CACTTGATGTCTCATCCAT
CCCAGGCCCCTTAAGCCCG -> CCAGGCCCCTTAAGCCCGC
TACACGTGTAGTGCTAGCC -> ACACGTGTAGTGCTAGCCT
TTGAAGAAATGGTATGGGT -> TGAAGAAATGGTATGGGTA
GCGCCTGTCGAAGTCATAC -> CGCCTGTCGAAGTCATACA
AACGCATGGAGAAATGCCG -> ACGCATGGAGAAATGCCGT
CGACCCCGCGACAGGGACG -> GACCCCGCGACAGGGACGC
GAGGTGACCGTCAGTGGGT -> AGGTGACCGTCAGTGGGTA
TATGAGCTTGCACGCGCGG -> ATGAGCTTGCACGCGCGGT
AACCGTGAATCCGGCGGGA -> ACCGTGAATCCGGCGGGAG
TACTTAAATACGTACGGAT -> ACTTAAATACGTACGGATC
GGTATTCCGGCAGAGCCAC -> GTATTCCGGCAGAGCCACG
CTGTCGAAGTCATACAATG -> TGTCGAAGTCATACAATGA
CAGTAAGTGCCACTCCGGC -> AGTAAGTGCCACTCCGGCG
TTAAACTTTGATAGCCGCT -> TAAACTTTGATAGCCGCTG
AACCGATCCAGGACCCTAT -> ACCGATCCAGGACCCTATT
TGGTAGCCACGCGAGCTGG -> GGTAGCCACGCGAGCTGGG
TCCTATACCCATGCACACC -> CCTATACCCATGCACACCG
AACTAATGTCCACAACCAG -> ACTAATGTCCACAACCAGG
GGTTTGAGGCCCAGAATGA -> GTTTGAGGCCCAGAATGAG
GGCATTTTAGACCACGCCC -> GCATTTTAGACCACGCCCT
GTCGAAGTCATACAATGAT -> TCGAAGTCATACAATGATC
AACTGCTTGAAGAAATGGT -> ACTGCTTGAAGAAATGGTA
ACCATTTCACTTGATGTCT -> CCATTTCACTTGATGTCTC
GGGACGTGGCATGAACATT -> GGACGTGGCATGAACATTT
TCGAGGCCGGAAGAGCAGT -> CGAGGCCGGAAGAGCAGTC
TAGTTGATTCTGGCCTCTC -> AGTTGATTCTGGCCTCTCT
ACCGAAAGTAAGTATGTAT -> CCGAAAGTAAGTATGTATA
AATAAACACCACTAGTACT -> ATAAACACCACTAGTACTC
GGGAGTAAGATGGTCATGG -> GGAGTAAGATGGTCATGGG
AGGAAATCGGGACACAAGT -> GGAAATCGGGACACAAGTG
ATCCCGGTTTGAGGCCCAG -> TCCCGGTTTGAGGCCCAGA
CCACGCGAGCTGGGAGGTG -> CACGCGAGCTGGGAGGTGA
TACAATGATCCCCTCCTGC -> ACAATGATCCCCTCCTGCG
CTGCTTGAAGAAATGGTAT -> TGCTTGAAGAAATGGTATG
CTTTTACAGGGGCCTTTCC -> TTTTACAGGGGCCTTTCCT
TAAAACTGCTTGAAGAAAT -> AAAACTGCTTGAAGAAATG
AAAACTGCTTGAAGAAATG -> AAACTGCTTGAAGAAATGG
CATCTTAGATTTCCTATCT -> ATCTTAGATTTCCTATCTG
GCCCTGTTGACCGAAAGTA -> CCCTGTTGACCGAAAGTAA
ATGTCGCAGCAGTAAGTGC -> TGTCGCAGCAGTAAGTGCC
TACCGTACTCTCGGACTTT -> ACCGTACTCTCGGACTTTG
GGTGACCGTCAGTGGGTAA -> GTGACCGTCAGTGGGTAAG
GGAGGTGACCGTCAGTGGG -> GAGGTGACCGTCAGTGGGT
TTTAGGCGGATCGCATGTG -> TTAGGCGGATCGCATGTGA
TTAGACAAATAGCTGTAGT -> TAGACAAATAGCTGTAGTT
TAGTATTATTAAAGTCGTT -> AGTATTATTAAAGTCGTTT
GGTTTTTTGAGCCCCTCTC -> GTTTTTTGAGCCCCTCTCA
AAAGCCCGCGTTCAGAGAT -> AAGCCCGCGTTCAGAGATG
AGGACAGTACTTAAATACG -> GGACAGTACTTAAATACGT
GCAGTAAACACAGCCACGC -> CAGTAAACACAGCCACGCG
GAATATAAGCCACGCGAGC -> AATATAAGCCACGCGAGCT
GTAGTGCTGATGAATAAGC -> TAGTGCTGATGAATAAGCT
AGCTTGCACGCGCGGTTTT -> GCTTGCACGCGCGGTTTTT
AGCTGGGAGATTCCCTTCA -> GCTGGGAGATTCCCTTCAG
ACATTTATAACCCCGAAGA -> CATTTATAACCCCGAAGAT
TGACTAACCGTCATTTATT -> GACTAACCGTCATTTATTT
GTCACATTCGAAGTTTCTT -> TCACATTCGAAGTTTCTTC
AGCCGCTGACAGAGAAATG -> GCCGCTGACAGAGAAATGA
GAAATGTAATGAATGTAAG -> AAATGTAATGAATGTAAGC
GCCACGCGAGCTGGGAGAT -> CCACGCGAGCTGGGAGATT
CCGTGTGATTCTTACGAAC -> CGTGTGATTCTTACGAACA
TCTGGTGCAGTAAACACAG -> CTGGTGCAGTAAACACAGC
TCGCTGCCGAACAACCCCG -> CGCTGCCGAACAACCCCGA
ATTAGTCTGGGTAAGGCCA -> TTAGTCTGGGTAAGGCCAA
TCTCGGACTTTGAGGCGAG -> CTCGGACTTTGAGGCGAGT
GTGGGTAAGGCCAAGGACG -> TGGGTAAGGCCAAGGACGC,TGGGTAAGGCCAAGGACGC
GCATGTTTAGGCGGATCGC -> CATGTTTAGGCGGATCGCA
TATCTGAAAACTAATGTCC -> ATCTGAAAACTAATGTCCA
AGAAATGGTATGGGTAGGG -> GAAATGGTATGGGTAGGGG
GGCAAATTATCCCGACACT -> GCAAATTATCCCGACACTT
GGAGAAATGCCGTGTGATT -> GAGAAATGCCGTGTGATTC
AGAATGAGGGCTGCCGAGG -> GAATGAGGGCTGCCGAGGC
GGCTAGAAGTAGTATTATT -> GCTAGAAGTAGTATTATTA
CTGCCGAGGCTAGCCACTG -> TGCCGAGGCTAGCCACTGA
CTTTGATAGCCGCTGACAG -> TTTGATAGCCGCTGACAGA
CCGGCGAGCCCCCAAGTAT -> CGGCGAGCCCCCAAGTATC
GAAATGCCGTGTGATTCTT -> AAATGCCGTGTGATTCTTA
CAGCTTGGGACTGCGGGCT -> AGCTTGGGACTGCGGGCTA
GCGATTCGAGGCCGGAAGA -> CGATTCGAGGCCGGAAGAG
CCGCTTGTTGGCCCGCCAC -> CGCTTGTTGGCCCGCCACC
TTATTTATGGATCTTTCTC -> TATTTATGGATCTTTCTCT
CGAGCTGGGAGCCAAATTA -> GAGCTGGGAGCCAAATTAG
AGTATCTGTGCTGCGTCAT -> GTATCTGTGCTGCGTCATA
TAATACCGCCAATAAGTCT -> AATACCGCCAATAAGTCTC
ATCTGTGCTGCGTCATAAT -> TCTGTGCTGCGTCATAATT
TGGGAGATTCCCTTCAGTG -> GGGAGATTCCCTTCAGTGG
AACTTGGCTTAAACTTTGA -> ACTTGGCTTAAACTTTGAT
AAGATGCGCGGCAACCTAC -> AGATGCGCGGCAACCTACA
ATTCTAAATATAGCGAAGC -> TTCTAAATATAGCGAAGCC
TTCTGGCCTCTCTCCGCGT -> TCTGGCCTCTCTCCGCGTG
TGATGAATAAGCTAGAGAC -> GATGAATAAGCTAGAGACC
GTCGCCGTAAACTTGCGTG -> TCGCCGTAAACTTGCGTGT
GGTTAGCAACAACCGTGCC -> GTTAGCAACAACCGTGCCT
GACGCAGGCATTTTAGACC -> ACGCAGGCATTTTAGACCA
AATTGGTAATACCGCCAAT -> ATTGGTAATACCGCCAATA
TACCCATGCACACCGTAGC -> ACCCATGCACACCGTAGCC
TGTAATGAATGTAAGCGTC -> GTAATGAATGTAAGCGTCC
CACCACAGCTTGGGACTGC -> ACCACAGCTTGGGACTGCG
AAATATAGCGAAGCCCGCT -> AATATAGCGAAGCCCGCTT
ACTTGTCGGGCTGTAGCAC -> CTTGTCGGGCTGTAGCACG
ACGCCCTGTTGACCGAAAG -> CGCCCTGTTGACCGAAAGT
CCCGGTTTACAAATCGTGA -> CCGGTTTACAAATCGTGAG
GCCGATTAATGGAGGAATG -> CCGATTAATGGAGGAATGG
AGCAGTCGCAAGAATCGTC -> GCAGTCGCAAGAATCGTCA
CATTAAAGGGAAGATCTAA -> ATTAAAGGGAAGATCTAAG
TGGCATGAACATTTATAAC -> GGCATGAACATTTATAACC
AGCCACGCGAGCTGGGAGG -> GCCACGCGAGCTGGGAGGT
AGCCACGCGAGCTGGGAGC -> GCCACGCGAGCTGGGAGCC
AGCCACGCGAGCTGGGAGA -> GCCACGCGAGCTGGGAGAT
TGAACCGTGAATCCGGCGG -> GAACCGTGAATCCGGCGGG
AAGTATCTGTGCTGCGTCA -> AGTATCTGTGCTGCGTCAT
TGAAAACTAATGTCCACAA -> GAAAACTAATGTCCACAAC
AGCCACGCGAGCTGGGAGT -> GCCACGCGAGCTGGGAGTA
CTGAACTCTTCGAAGATCG -> TGAACTCTTCGAAGATCGT
TAAGTCTCCCGAAAAGCCC -> AAGTCTCCCGAAAAGCCCG
AATCACAACTGAAGGGGGC -> ATCACAACTGAAGGGGGCC
CGCTCGGATGTGTTAGACA -> GCTCGGATGTGTTAGACAA
TGTCCACAACCAGGACGAC -> GTCCACAACCAGGACGACC
CCACCCCCGGTTTACAAAT -> CACCCCCGGTTTACAAATC
AGGGCAGATTCAGTACCGC -> GGGCAGATTCAGTACCGCT
GAACCCGGTCCAATAATCT -> AACCCGGTCCAATAATCTA
GGGAATCTAATATAATTGC -> GGAATCTAATATAATTGCC
CAAATTAGTCTGGGTAAGG -> AAATTAGTCTGGGTAAGGC
GGACGCAGGCATTTTAGAC -> GACGCAGGCATTTTAGACC
TCAACCAGAGATTCTGCAA -> CAACCAGAGATTCTGCAAT
GCAAGAATCGTCACACCCC -> CAAGAATCGTCACACCCCC
AGATGTCGAGAAACACGCG -> GATGTCGAGAAACACGCGC
CGCGGTACCGTACTCTCGG -> GCGGTACCGTACTCTCGGA
AAACTTTGATAGCCGCTGA -> AACTTTGATAGCCGCTGAC
TTGCAGTAGCGGTGGCAAA -> TGCAGTAGCGGTGGCAAAT
TCGAGAAACACGCGCGGTA -> CGAGAAACACGCGCGGTAC
TTTGCTTATGTACGGCAGT -> TTGCTTATGTACGGCAGTA
TTCAGGCTAGAAGTAGTAT -> TCAGGCTAGAAGTAGTATT
GTAGGGGAACCCGGTCCAA -> TAGGGGAACCCGGTCCAAT
CCCTCCTGCGGAGATTAGG -> CCTCCTGCGGAGATTAGGT
CAATACGTGCGTCTGAAAC -> AATACGTGCGTCTGAAACA
CACTAATCCGACTACATAG -> ACTAATCCGACTACATAGC
CAGGGACGCAAACGGAATT -> AGGGACGCAAACGGAATTC
CGCCGTAGTACCAGGGCCT -> GCCGTAGTACCAGGGCCTA
AAACACGCGCGGTACCGTA -> AACACGCGCGGTACCGTAC
ACCACAGCTTGGGACTGCG -> CCACAGCTTGGGACTGCGG
CTAGCCGGGACGTGGCATG -> TAGCCGGGACGTGGCATGA
CCACTGAACTCTTCGAAGA -> CACTGAACTCTTCGAAGAT
GACTTTGAGGCGAGTACTT -> ACTTTGAGGCGAGTACTTG
GAAGAAATGGTATGGGTAG -> AAGAAATGGTATGGGTAGG
ACAAATCGTGAGTCTTTGT -> CAAATCGTGAGTCTTTGTG
GCCCCTTAAGCCCGCTGTG -> CCCCTTAAGCCCGCTGTGC
AATGGCAAATAAACACCAC -> ATGGCAAATAAACACCACT
GGCCAAGGACGCAGGCATT -> GCCAAGGACGCAGGCATTT
AGTCTTTGTGGTACATGGC -> GTCTTTGTGGTACATGGCC
GTCTAAGTAGTCTGGCTGG -> TCTAAGTAGTCTGGCTGGA
TTGAACCGTGAATCCGGCG -> TGAACCGTGAATCCGGCGG
AGTGGGTAAGGCCAAGGAC -> GTGGGTAAGGCCAAGGACG,GTGGGTAAGGCCAAGGACG
AACTGAAGGGGGCCTATCG -> ACTGAAGGGGGCCTATCGT
GCTGATGAATAAGCTAGAG -> CTGATGAATAAGCTAGAGA
GGAGATTCCCTTCAGTGGG -> GAGATTCCCTTCAGTGGGT
AACAACCGTGCCTGTCCTA -> ACAACCGTGCCTGTCCTAT
CTGTAGCACGAATTTTATA -> TGTAGCACGAATTTTATAC
CAGCTGGGGTGAGAACTTG -> AGCTGGGGTGAGAACTTGG
TTTACAGGGGCCTTTCCTG -> TTACAGGGGCCTTTCCTGA
CACAAGTGCGACCCATGAA -> ACAAGTGCGACCCATGAAT
GGTTTGAACCGTGAATCCG -> GTTTGAACCGTGAATCCGG
GCCACGCGAGCTGGGAGGT -> CCACGCGAGCTGGGAGGTG
CAAGACGTAGTGCTGATGA -> AAGACGTAGTGCTGATGAA
GCCTTGCAGTAGCGGTGGC -> CCTTGCAGTAGCGGTGGCA
CGCTGTGCATACTCAACCA -> GCTGTGCATACTCAACCAG
GGTACATGGCCACTAATTG -> GTACATGGCCACTAATTGT
GGAGATTAGGTTACACCAT -> GAGATTAGGTTACACCATC
GCTAGCCACTGAAAGGTTA -> CTAGCCACTGAAAGGTTAG
AATAAGTCTCCCGAAAAGC -> ATAAGTCTCCCGAAAAGCC
ATACCGCCAATAAGTCTCC -> TACCGCCAATAAGTCTCCC
AGAAACACGCGCGGTACCG -> GAAACACGCGCGGTACCGT
GAAATGACTAACCGTCATT -> AAATGACTAACCGTCATTT
GAAGTTTCTTCATTAAAGG -> AAGTTTCTTCATTAAAGGG
CATTTATAACCCCGAAGAT -> ATTTATAACCCCGAAGATG
ATAGCGAAGCCCGCTTGTT -> TAGCGAAGCCCGCTTGTTG
AGGAATGGCAAATAAACAC -> GGAATGGCAAATAAACACC
CCCCGTCTTACAATTGGTA -> CCCGTCTTACAATTGGTAA
GGCGAGGGATAACGCTCCA -> GCGAGGGATAACGCTCCAC
CTCCCAGGAGTACGGTATC -> TCCCAGGAGTACGGTATCC
GGTCTAAGTAGTCTGGCTG -> GTCTAAGTAGTCTGGCTGG
GCCGTAAACTTGCGTGTCA -> CCGTAAACTTGCGTGTCAC
CGCAGGCATTTTAGACCAC -> GCAGGCATTTTAGACCACG
AAATAAACACCACTAGTAC -> AATAAACACCACTAGTACT
CGTCATTTATTTATGGATC -> GTCATTTATTTATGGATCT
CCTATTCTAAATATAGCGA -> CTATTCTAAATATAGCGAA
GGACCCTATTCTAAATATA -> GACCCTATTCTAAATATAG
ACAGGAATGTCGCAGCAGT -> CAGGAATGTCGCAGCAGTA
GCCAAGGACGCAGGCATTT -> CCAAGGACGCAGGCATTTT
CTGGGAGTAAGATGGTCAT -> TGGGAGTAAGATGGTCATG
CTTAGATTTCCTATCTGCC -> TTAGATTTCCTATCTGCCA
AACCGTCATTTATTTATGG -> ACCGTCATTTATTTATGGA
GTAGTCTGGCTGGAAATGT -> TAGTCTGGCTGGAAATGTA
TAGTCGACTGGATCCTCTC -> AGTCGACTGGATCCTCTCG
GTGGCAAATTATCCCGACA -> TGGCAAATTATCCCGACAC
AGACCACTAATCCGACTAC -> GACCACTAATCCGACTACA
AATGTAAGCGTCCCGCTGA -> ATGTAAGCGTCCCGCTGAA
TGTGGTACATGGCCACTAA -> GTGGTACATGGCCACTAAT
TCTCCCAGGAGTACGGTAT -> CTCCCAGGAGTACGGTATC
TCGGATGTGTTAGACAAAT -> CGGATGTGTTAGACAAATA
GAAGATCGTATTTAGTTGA -> AAGATCGTATTTAGTTGAT
AGGCCCAGAATGAGGGCTG -> GGCCCAGAATGAGGGCTGC
TACTCTCGGACTTTGAGGC -> ACTCTCGGACTTTGAGGCG
GAAAGTAAGTATGTATATC -> AAAGTAAGTATGTATATCA
CAACAACCGTGCCTGTCCT -> AACAACCGTGCCTGTCCTA
CTTCCACAAACCGATCCAG -> TTCCACAAACCGATCCAGG
TGCTCTCCCAGGAGTACGG -> GCTCTCCCAGGAGTACGGT
TGTATATCATGTAAAACTG -> GTATATCATGTAAAACTGC
TGGTCATGGGTAAGGCCAA -> GGTCATGGGTAAGGCCAAG
TACTCGCGATTCGAGGCCG -> ACTCGCGATTCGAGGCCGG
TAACCGTCATTTATTTATG -> AACCGTCATTTATTTATGG
GAATGTAAGCGTCCCGCTG -> AATGTAAGCGTCCCGCTGA
CTGCGTCATAATTTCGTGC -> TGCGTCATAATTTCGTGCA
GATTCGAGGCCGGAAGAGC -> ATTCGAGGCCGGAAGAGCA
GATCTTTCTCTGGTGCAGT -> ATCTTTCTCTGGTGCAGTA
TGAATCCGGCGGGAGGAAA -> GAATCCGGCGGGAGGAAAT
GCCCGTAACGCATGGAGAA -> CCCGTAACGCATGGAGAAA
GCGCGGTTTTTTGAGCCCC -> CGCGGTTTTTTGAGCCCCT
TGATTCTTACGAACACTTG -> GATTCTTACGAACACTTGT
CCAAGGACGCTTAGCCAGC -> CAAGGACGCTTAGCCAGCG
CTTGTCGGGCTGTAGCACG -> TTGTCGGGCTGTAGCACGA
TCGTGCATGTTTAGGCGGA -> CGTGCATGTTTAGGCGGAT
ACTGAAGGGGGCCTATCGT -> CTGAAGGGGGCCTATCGTA
TAGCCGCTGACAGAGAAAT -> AGCCGCTGACAGAGAAATG
AGTCGACTGGATCCTCTCG -> GTCGACTGGATCCTCTCGG
CAACCAGGACGACCCCGCG -> AACCAGGACGACCCCGCGA
ATTTATTTATGGATCTTTC -> TTTATTTATGGATCTTTCT
TTTATTTATGGATCTTTCT -> TTATTTATGGATCTTTCTC
AGCACGAATTTTATACAAG -> GCACGAATTTTATACAAGT
CGAAGTTTCTTCATTAAAG -> GAAGTTTCTTCATTAAAGG
TGGAGGAATGGCAAATAAA -> GGAGGAATGGCAAATAAAC
AACCCGGTCCAATAATCTA -> ACCCGGTCCAATAATCTAC
ATTAAAGTCGTTTAGTCGA -> TTAAAGTCGTTTAGTCGAC
CGCGGTTTTTTGAGCCCCT -> GCGGTTTTTTGAGCCCCTC
TATTTATGGATCTTTCTCT -> ATTTATGGATCTTTCTCTG
TTCTTACGAACACTTGTCG -> TCTTACGAACACTTGTCGG
CTCAATGCGCTAGCCGGGA -> TCAATGCGCTAGCCGGGAC
CTTTCCTGAGGGAATCTAA -> TTTCCTGAGGGAATCTAAT
TGGCCTTGCAGTAGCGGTG -> GGCCTTGCAGTAGCGGTGG
ACTTTGAGGCGAGTACTTG -> CTTTGAGGCGAGTACTTGA
ATAGCTGACGATAGTACTC -> TAGCTGACGATAGTACTCG
CTGGAAATGTAATGAATGT -> TGGAAATGTAATGAATGTA
GACACAAGTGCGACCCATG -> ACACAAGTGCGACCCATGA
GAGCCACGCGAGCTGGGAG -> AGCCACGCGAGCTGGGAGG
ACTTAAATACGTACGGATC -> CTTAAATACGTACGGATCT
TCCTATCTGCCACTTCCAG -> CCTATCTGCCACTTCCAGC
ATGGCAAATAAACACCACT -> TGGCAAATAAACACCACTA
CATGCACACCGTAGCCCAC -> ATGCACACCGTAGCCCACT
CCGCCAATAAGTCTCCCGA -> CGCCAATAAGTCTCCCGAA
AGGCCAAGGACGCTATCCC -> GGCCAAGGACGCTATCCCT
GCATGTGATGCTGGTGGCC -> CATGTGATGCTGGTGGCCT
CGAGGCCGGAAGAGCAGTC -> GAGGCCGGAAGAGCAGTCG
GAGTAAGATGGTCATGGGT -> AGTAAGATGGTCATGGGTA
ATGGAGAAATGCCGTGTGA -> TGGAGAAATGCCGTGTGAT
CGAACACTTGTCGGGCTGT -> GAACACTTGTCGGGCTGTA
AACCCCGAGGGCAGATTCA -> ACCCCGAGGGCAGATTCAG
TTACAGGGGCCTTTCCTGA -> TACAGGGGCCTTTCCTGAG
CCTCCGAACAGGAATGTCG -> CTCCGAACAGGAATGTCGC
CGCTATCCCTGCGCCTGTC -> GCTATCCCTGCGCCTGTCG
TTTGGGATTATCCCAGGCC -> TTGGGATTATCCCAGGCCC
GCTGGAAATGTAATGAATG -> CTGGAAATGTAATGAATGT
AGGCCAAGGACGCACCCCG -> GGCCAAGGACGCACCCCGT
AGTACCGCTGCCGAGGTCT -> GTACCGCTGCCGAGGTCTA
GCGTCCCGCTGAAGGACAG -> CGTCCCGCTGAAGGACAGT
CTTTGTGAGTTCTGCGCTC -> TTTGTGAGTTCTGCGCTCG
AAATGGTATGGGTAGGGGA -> AATGGTATGGGTAGGGGAA
TGGGAGGTGACCGTCAGTG -> GGGAGGTGACCGTCAGTGG
GAGAACTTGGCTTAAACTT -> AGAACTTGGCTTAAACTTT
CCTTCAGTGGGTAAGGCCA -> CTTCAGTGGGTAAGGCCAA
CGCCAGAATTTTAATCCCG -> GCCAGAATTTTAATCCCGG
TGGAAATGTAATGAATGTA -> GGAAATGTAATGAATGTAA
AGTACTCGCGATTCGAGGC -> GTACTCGCGATTCGAGGCC
ATCGTATTTAGTTGATTCT -> TCGTATTTAGTTGATTCTG
CACAACTGAAGGGGGCCTA -> ACAACTGAAGGGGGCCTAT
GCCACGCGAGCTGGGAGTA -> CCACGCGAGCTGGGAGTAA
CATGGCCACTAATTGTCCT -> ATGGCCACTAATTGTCCTG
CCGTACTCTCGGACTTTGA -> CGTACTCTCGGACTTTGAG
TGCGCTAGCCGGGACGTGG -> GCGCTAGCCGGGACGTGGC
CTATCGTATCTTGGTAGCC -> TATCGTATCTTGGTAGCCA
CCAGGACGACCCCGCGACA -> CAGGACGACCCCGCGACAG
GACTCCCTTTGTCGCCGTA -> ACTCCCTTTGTCGCCGTAA
CCGGTCCAATAATCTACTC -> CGGTCCAATAATCTACTCT
TAAGGCCAAGGACGCTATC -> AAGGCCAAGGACGCTATCC
GGACGTGGCATGAACATTT -> GACGTGGCATGAACATTTA
GGATGTGTTAGACAAATAG -> GATGTGTTAGACAAATAGC
GCAAATAAACACCACTAGT -> CAAATAAACACCACTAGTA
TTCAGTGGGTAAGGCCAAG -> TCAGTGGGTAAGGCCAAGG
TTATGTACGGCAGTACGTC -> TATGTACGGCAGTACGTCC
GCGAAGCCCGCTTGTTGGC -> CGAAGCCCGCTTGTTGGCC
GCAGCAGTAAGTGCCACTC -> CAGCAGTAAGTGCCACTCC
CTAGTACTCGCTGCCGAAC -> TAGTACTCGCTGCCGAACA
GAGCCAAATTAGTCTGGGT -> AGCCAAATTAGTCTGGGTA
AATCCGACTACATAGCTGA -> ATCCGACTACATAGCTGAC
TGCCGAGGCTAGCCACTGA -> GCCGAGGCTAGCCACTGAA
GGCTTAATTTGGGATTATC -> GCTTAATTTGGGATTATCC
AGGCCCCTTAAGCCCGCTG -> GGCCCCTTAAGCCCGCTGT
GTTAGACAAATAGCTGTAG -> TTAGACAAATAGCTGTAGT
AGGAGTACGGTATCCCATT -> GGAGTACGGTATCCCATTG
AGCCCGCTGTGCATACTCA -> GCCCGCTGTGCATACTCAA
TTCTGCAATACGTGCGTCT -> TCTGCAATACGTGCGTCTG
GACCACGCCCTGTTGACCG -> ACCACGCCCTGTTGACCGA
CAATCACAACTGAAGGGGG -> AATCACAACTGAAGGGGGC
ACCCCGTATGGCTCAGCCC -> CCCCGTATGGCTCAGCCCG
GCAGTAGCGGTGGCAAATT -> CAGTAGCGGTGGCAAATTA
GTGCCTGTCCTATACCCAT -> TGCCTGTCCTATACCCATG
CTTGTTGGCCCGCCACCCC -> TTGTTGGCCCGCCACCCCC
ATAATTGCCGATTAATGGA -> TAATTGCCGATTAATGGAG
ATAAGCCACGCGAGCTGGG -> TAAGCCACGCGAGCTGGGA
GGTATGGGTAGGGGAACCC -> GTATGGGTAGGGGAACCCG
CACCGTAGCCCACTTTTAC -> ACCGTAGCCCACTTTTACA
CGAAAAGCCCGCGTTCAGA -> GAAAAGCCCGCGTTCAGAG
AATTACGCCAGAATTTTAA -> ATTACGCCAGAATTTTAAT
TTGACCGAAAGTAAGTATG -> TGACCGAAAGTAAGTATGT
GAGGGCTGCCGAGGCTAGC -> AGGGCTGCCGAGGCTAGCC
ACGCATGGAGAAATGCCGT -> CGCATGGAGAAATGCCGTG
TAGCAACAACCGTGCCTGT -> AGCAACAACCGTGCCTGTC
GTAAACTTGCGTGTCACAT -> TAAACTTGCGTGTCACATT
GCGAGCTGGGAGGTGACCG -> CGAGCTGGGAGGTGACCGT
TTACAAATCGTGAGTCTTT -> TACAAATCGTGAGTCTTTG
GCTGACGATAGTACTCGCG -> CTGACGATAGTACTCGCGA
TCTAAATATAGCGAAGCCC -> CTAAATATAGCGAAGCCCG
ATACGTACGGATCTGCTCT -> TACGTACGGATCTGCTCTC
CATAATTTCGTGCATGTTT -> ATAATTTCGTGCATGTTTA
TTTATAACCCCGAAGATGC -> TTATAACCCCGAAGATGCG
GTCTTACAATTGGTAATAC -> TCTTACAATTGGTAATACC
CTCGCTGCCGAACAACCCC -> TCGCTGCCGAACAACCCCG
TAAGGCCAAGGACGCAGGC -> AAGGCCAAGGACGCAGGCA
AGTCATACAATGATCCCCT -> GTCATACAATGATCCCCTC
CAGGCTAGAAGTAGTATTA -> AGGCTAGAAGTAGTATTAT
CGAGCTGGGAGTAAGATGG -> GAGCTGGGAGTAAGATGGT
CGGTATCGGTACTGGGAAG -> GGTATCGGTACTGGGAAGG
CATGAACATTTATAACCCC -> ATGAACATTTATAACCCCG
CAGCCCGTAACGCATGGAG -> AGCCCGTAACGCATGGAGA
TTCAAGACGTAGTGCTGAT -> TCAAGACGTAGTGCTGATG
AAGGGAAGATCTAAGACTC -> AGGGAAGATCTAAGACTCA
CACGTGTAGTGCTAGCCTG -> ACGTGTAGTGCTAGCCTGA
CGCTCCACTGAACTCTTCG -> GCTCCACTGAACTCTTCGA
GGCCTACAATCACAACTGA -> GCCTACAATCACAACTGAA
GGGAGGTGACCGTCAGTGG -> GGAGGTGACCGTCAGTGGG
GTTTAATCAATTACGCCAG -> TTTAATCAATTACGCCAGA
TAGCCAGCGTCGGACTTTC -> AGCCAGCGTCGGACTTTCT
GCGGTACCGTACTCTCGGA -> CGGTACCGTACTCTCGGAC
ATGTTTAGGCGGATCGCAT -> TGTTTAGGCGGATCGCATG
TAAGTATGTATATCATGTA -> AAGTATGTATATCATGTAA
GCCACGCGAGCTGGGAGCC -> CCACGCGAGCTGGGAGCCA
CGGAAGAGCAGTCGCAAGA -> GGAAGAGCAGTCGCAAGAA
CACGCCCTGTTGACCGAAA -> ACGCCCTGTTGACCGAAAG
TGCGGGCTATCTGAAAACT -> GCGGGCTATCTGAAAACTA
TAAGTAGTCTGGCTGGAAA -> AAGTAGTCTGGCTGGAAAT
ACTTTCTCGGCGAGGGATA -> CTTTCTCGGCGAGGGATAA
CCAGAATGAGGGCTGCCGA -> CAGAATGAGGGCTGCCGAG
GTCCCGCTGAAGGACAGTA -> TCCCGCTGAAGGACAGTAC
GACGCTATCCCTGCGCCTG -> ACGCTATCCCTGCGCCTGT
CGAGGGCAGATTCAGTACC -> GAGGGCAGATTCAGTACCG
AGAAATGACTAACCGTCAT -> GAAATGACTAACCGTCATT
CAATTACGCCAGAATTTTA -> AATTACGCCAGAATTTTAA
CGACTACATAGCTGACGAT -> GACTACATAGCTGACGATA
ACGCAAACGGAATTCTCGC -> CGCAAACGGAATTCTCGCC
CTGTTGACCGAAAGTAAGT -> TGTTGACCGAAAGTAAGTA
TCGGACTTTCTCGGCGAGG -> CGGACTTTCTCGGCGAGGG
GTTCAGGCTAGAAGTAGTA -> TTCAGGCTAGAAGTAGTAT
CTGGGAGGTGACCGTCAGT -> TGGGAGGTGACCGTCAGTG
TGCATACTCAACCAGAGAT -> GCATACTCAACCAGAGATT
GCAGTCGCAAGAATCGTCA -> CAGTCGCAAGAATCGTCAC
ATCTACTCTTTCAGATGGC -> TCTACTCTTTCAGATGGCC
CATGTTTAGGCGGATCGCA -> ATGTTTAGGCGGATCGCAT
TGAAAGGTTAGCAACAACC -> GAAAGGTTAGCAACAACCG
GGAATGGCAAATAAACACC -> GAATGGCAAATAAACACCA
CAGCCACGCGAGCTGGGAG -> AGCCACGCGAGCTGGGAGC
GGATCCTCTCGGTTTGAAC -> GATCCTCTCGGTTTGAACC
TTTCACTTGATGTCTCATC -> TTCACTTGATGTCTCATCC
ATTGTTTAATCAATTACGC -> TTGTTTAATCAATTACGCC
GTGAGTTCTGCGCTCGGAT -> TGAGTTCTGCGCTCGGATG
GCCAAGGACGCTATCCCTG -> CCAAGGACGCTATCCCTGC
TTAGCCAGCGTCGGACTTT -> TAGCCAGCGTCGGACTTTC
CGTAACGCATGGAGAAATG -> GTAACGCATGGAGAAATGC
GATGCACCATTTCACTTGA -> ATGCACCATTTCACTTGAT
ACGGTATCCCATTGATGCA -> CGGTATCCCATTGATGCAC
CATACAATGATCCCCTCCT -> ATACAATGATCCCCTCCTG
TCAGCCCGTAACGCATGGA -> CAGCCCGTAACGCATGGAG
CTCCGGCGAGCCCCCAAGT -> TCCGGCGAGCCCCCAAGTA
GTGTGATTCTTACGAACAC -> TGTGATTCTTACGAACACT
TTCCTGAGGGAATCTAATA -> TCCTGAGGGAATCTAATAT
GAGTCTTTGTGGTACATGG -> AGTCTTTGTGGTACATGGC
GACAGTACTTAAATACGTA -> ACAGTACTTAAATACGTAC
GTAATGAATGTAAGCGTCC -> TAATGAATGTAAGCGTCCC
AGCGTCCCGCTGAAGGACA -> GCGTCCCGCTGAAGGACAG
CATGAATATAAGCCACGCG -> ATGAATATAAGCCACGCGA
GCTGGGAGTAAGATGGTCA -> CTGGGAGTAAGATGGTCAT
GACTACATAGCTGACGATA -> ACTACATAGCTGACGATAG
GGATCTTTCTCTGGTGCAG -> GATCTTTCTCTGGTGCAGT
CAATGCGCTAGCCGGGACG -> AATGCGCTAGCCGGGACGT
CATGTAAAACTGCTTGAAG -> ATGTAAAACTGCTTGAAGA
CCAGGCCCCTTAAGCCCGC -> CAGGCCCCTTAAGCCCGCT
CTCTCGGACTTTGAGGCGA -> TCTCGGACTTTGAGGCGAG
ATGGCTCAGCCCGTAACGC -> TGGCTCAGCCCGTAACGCA
GGTAGCCACGCGAGCTGGG -> GTAGCCACGCGAGCTGGGA
TACCAGGGCCTACAATCAC -> ACCAGGGCCTACAATCACA
CACTCCGGCGAGCCCCCAA -> ACTCCGGCGAGCCCCCAAG
AGACGTAGTGCTGATGAAT -> GACGTAGTGCTGATGAATA
CACGAATTTTATACAAGTA -> ACGAATTTTATACAAGTAC
ATTAATGGAGGAATGGCAA -> TTAATGGAGGAATGGCAAA
TGCTAGCCTGACTCCCTTT -> GCTAGCCTGACTCCCTTTG
CACCATCTTAGATTTCCTA -> ACCATCTTAGATTTCCTAT
AACGGAATTCTCGCCGTAG -> ACGGAATTCTCGCCGTAGT
ACTGCTTGAAGAAATGGTA -> CTGCTTGAAGAAATGGTAT
ACGCGCGGTACCGTACTCT -> CGCGCGGTACCGTACTCTC
TTATGGATCTTTCTCTGGT -> TATGGATCTTTCTCTGGTG
TTACGAACACTTGTCGGGC -> TACGAACACTTGTCGGGCT
GTACTCGCGATTCGAGGCC -> TACTCGCGATTCGAGGCCG
CAGTACCGCTGCCGAGGTC -> AGTACCGCTGCCGAGGTCT
AAGGACGCAGGCATTTTAG -> AGGACGCAGGCATTTTAGA
TAAGTGCCACTCCGGCGAG -> AAGTGCCACTCCGGCGAGC
TGGTGCAGTAAACACAGCC -> GGTGCAGTAAACACAGCCA
GTGCGACCCATGAATATAA -> TGCGACCCATGAATATAAG
AATGAATGTAAGCGTCCCG -> ATGAATGTAAGCGTCCCGC
CGCCTGTCGAAGTCATACA -> GCCTGTCGAAGTCATACAA
GTATATCATGTAAAACTGC -> TATATCATGTAAAACTGCT
GACGCAAACGGAATTCTCG -> ACGCAAACGGAATTCTCGC
CTCTTCGAAGATCGTATTT -> TCTTCGAAGATCGTATTTA
GAATCGTCACACCCCCGTC -> AATCGTCACACCCCCGTCT
GGGCCTTTCCTGAGGGAAT -> GGCCTTTCCTGAGGGAATC
CCCGGTCCAATAATCTACT -> CCGGTCCAATAATCTACTC
AACCAGAGATTCTGCAATA -> ACCAGAGATTCTGCAATAC
ACGCGAGCTGGGAGATTCC -> CGCGAGCTGGGAGATTCCC
TTCGAGGCCGGAAGAGCAG -> TCGAGGCCGGAAGAGCAGT
ATGTGTTAGACAAATAGCT -> TGTGTTAGACAAATAGCTG
GTAGTGCTAGCCTGACTCC -> TAGTGCTAGCCTGACTCCC
CCATCTTAGATTTCCTATC -> CATCTTAGATTTCCTATCT
TAGTGCTAGCCTGACTCCC -> AGTGCTAGCCTGACTCCCT
TTAATGGAGGAATGGCAAA -> TAATGGAGGAATGGCAAAT
ATAAGTCTCCCGAAAAGCC -> TAAGTCTCCCGAAAAGCCC
CGGCAGAGCCACGCGAGCT -> GGCAGAGCCACGCGAGCTG
GTCGAGAAACACGCGCGGT -> TCGAGAAACACGCGCGGTA
CTCTCCCAGGAGTACGGTA -> TCTCCCAGGAGTACGGTAT
CACTGAAAGGTTAGCAACA -> ACTGAAAGGTTAGCAACAA
GTAAACACAGCCACGCGAG -> TAAACACAGCCACGCGAGC
CGGTACCGTACTCTCGGAC -> GGTACCGTACTCTCGGACT
TACTCGCTGCCGAACAACC -> ACTCGCTGCCGAACAACCC
CCTTTCCTGAGGGAATCTA -> CTTTCCTGAGGGAATCTAA
TTCTAAATATAGCGAAGCC -> TCTAAATATAGCGAAGCCC
TCATTTATTTATGGATCTT -> CATTTATTTATGGATCTTT
TATATCATGTAAAACTGCT -> ATATCATGTAAAACTGCTT
CAAGTGCGACCCATGAATA -> AAGTGCGACCCATGAATAT
GTTAGCAACAACCGTGCCT -> TTAGCAACAACCGTGCCTG
CGCGAGCTGGGAGTAAGAT -> GCGAGCTGGGAGTAAGATG
GCACGCGCGGTTTTTTGAG -> CACGCGCGGTTTTTTGAGC
GCGAGCTGGGAGCCAAATT -> CGAGCTGGGAGCCAAATTA
CTGAAAGGTTAGCAACAAC -> TGAAAGGTTAGCAACAACC
TTATAACCCCGAAGATGCG -> TATAACCCCGAAGATGCGC
GGGGTGAGAACTTGGCTTA -> GGGTGAGAACTTGGCTTAA
GGATTATCCCAGGCCCCTT -> GATTATCCCAGGCCCCTTA
AGCCCCTCTCAATGCGCTA -> GCCCCTCTCAATGCGCTAG
TAGTACTCGCGATTCGAGG -> AGTACTCGCGATTCGAGGC
CCTCTCGGTTTGAACCGTG -> CTCTCGGTTTGAACCGTGA
GGGACGCAAACGGAATTCT -> GGACGCAAACGGAATTCTC
CGTAAACTTGCGTGTCACA -> GTAAACTTGCGTGTCACAT
GAGCTGGGAGTAAGATGGT -> AGCTGGGAGTAAGATGGTC
CCGTGGAGAGGTATGAGCT -> CGTGGAGAGGTATGAGCTT
GAATTTTAATCCCGGTTTG -> AATTTTAATCCCGGTTTGA
AAGGCCAAGGACGCTATCC -> AGGCCAAGGACGCTATCCC
GTCCCTGGCCTCCGAACAG -> TCCCTGGCCTCCGAACAGG
GCTCCACTGAACTCTTCGA -> CTCCACTGAACTCTTCGAA
GTTACACCATCTTAGATTT -> TTACACCATCTTAGATTTC
GGCCAAGGACGCTTAGCCA -> GCCAAGGACGCTTAGCCAG
GTGATTCTTACGAACACTT -> TGATTCTTACGAACACTTG
CTGTCCTATACCCATGCAC -> TGTCCTATACCCATGCACA
CCCCTTAAGCCCGCTGTGC -> CCCTTAAGCCCGCTGTGCA
GATCGCATGTGATGCTGGT -> ATCGCATGTGATGCTGGTG
GCTTGAAGAAATGGTATGG -> CTTGAAGAAATGGTATGGG
CCACTAATCCGACTACATA -> CACTAATCCGACTACATAG
GCAATACGTGCGTCTGAAA -> CAATACGTGCGTCTGAAAC
AGCTGACGATAGTACTCGC -> GCTGACGATAGTACTCGCG
TGCGGAGATTAGGTTACAC -> GCGGAGATTAGGTTACACC
GCCCGCGTTCAGAGATGTC -> CCCGCGTTCAGAGATGTCG
CGAGTACTTGAATTGTTTA -> GAGTACTTGAATTGTTTAA
CGCAAACGGAATTCTCGCC -> GCAAACGGAATTCTCGCCG
CCCGAAGATGCGCGGCAAC -> CCGAAGATGCGCGGCAACC
ACGCGCGGTTTTTTGAGCC -> CGCGCGGTTTTTTGAGCCC
TGGCCACTAATTGTCCTGG -> GGCCACTAATTGTCCTGGG
TGCATGTTTAGGCGGATCG -> GCATGTTTAGGCGGATCGC
GAGAGGTATGAGCTTGCAC -> AGAGGTATGAGCTTGCACG
TATAAGCCACGCGAGCTGG -> ATAAGCCACGCGAGCTGGG
CTGGCTGGAAATGTAATGA -> TGGCTGGAAATGTAATGAA
TCCCTTCAGTGGGTAAGGC -> CCCTTCAGTGGGTAAGGCC
AATTGCCGATTAATGGAGG -> ATTGCCGATTAATGGAGGA
GGACACAAGTGCGACCCAT -> GACACAAGTGCGACCCATG
CTGACAGAGAAATGACTAA -> TGACAGAGAAATGACTAAC
GACCCCGCGACAGGGACGC -> ACCCCGCGACAGGGACGCA
CGAGGTCTAAGTAGTCTGG -> GAGGTCTAAGTAGTCTGGC
CTCCATTTCAAGACGTAGT -> TCCATTTCAAGACGTAGTG
GGGGGCCTATCGTATCTTG -> GGGGCCTATCGTATCTTGG
ACGCTATCCCTGCGCCTGT -> CGCTATCCCTGCGCCTGTC
TGCAGTAGCGGTGGCAAAT -> GCAGTAGCGGTGGCAAATT
TGAAACAGGTATTCCGGCA -> GAAACAGGTATTCCGGCAG
ACTAATTGTCCTGGGAGAG -> CTAATTGTCCTGGGAGAGG
TCTGGCCTCTCTCCGCGTG -> CTGGCCTCTCTCCGCGTGT
AGTATGTATATCATGTAAA -> GTATGTATATCATGTAAAA
TGACCGTCAGTGGGTAAGG -> GACCGTCAGTGGGTAAGGC
TCTGCTCTCCCAGGAGTAC -> CTGCTCTCCCAGGAGTACG
AATCCGGCGGGAGGAAATC -> ATCCGGCGGGAGGAAATCG
GTCTGGCTGGAAATGTAAT -> TCTGGCTGGAAATGTAATG
CACTTGTCGGGCTGTAGCA -> ACTTGTCGGGCTGTAGCAC
GTGGAGAGGTATGAGCTTG -> TGGAGAGGTATGAGCTTGC
GTTTGCTTATGTACGGCAG -> TTTGCTTATGTACGGCAGT
CCCGAAAAGCCCGCGTTCA -> CCGAAAAGCCCGCGTTCAG
AGAAATGCCGTGTGATTCT -> GAAATGCCGTGTGATTCTT
ACGTGCGTCTGAAACAGGT -> CGTGCGTCTGAAACAGGTA
CGGTATCCCATTGATGCAC -> GGTATCCCATTGATGCACC
TCTAAGACTCACTCCATTT -> CTAAGACTCACTCCATTTC
TGTGAGTTCTGCGCTCGGA -> GTGAGTTCTGCGCTCGGAT
GCAAACGGAATTCTCGCCG -> CAAACGGAATTCTCGCCGT
ACCCGGTCCAATAATCTAC -> CCCGGTCCAATAATCTACT
ATTCTGGCCTCTCTCCGCG -> TTCTGGCCTCTCTCCGCGT
GAAAACTAATGTCCACAAC -> AAAACTAATGTCCACAACC
AGAGATGTCGAGAAACACG -> GAGATGTCGAGAAACACGC
GGGCCTACAATCACAACTG -> GGCCTACAATCACAACTGA
ACAGCCACGCGAGCTGGGA -> CAGCCACGCGAGCTGGGAG
CTTACGAACACTTGTCGGG -> TTACGAACACTTGTCGGGC
TGGCAAATAAACACCACTA -> GGCAAATAAACACCACTAG
GAGGGATAACGCTCCACTG -> AGGGATAACGCTCCACTGA
GTGACCGTCAGTGGGTAAG -> TGACCGTCAGTGGGTAAGG
TCGGTACTGGGAAGGACCC -> CGGTACTGGGAAGGACCCA
ATGAATGTAAGCGTCCCGC -> TGAATGTAAGCGTCCCGCT
CTTCATTAAAGGGAAGATC -> TTCATTAAAGGGAAGATCT
ACGTAGTGCTGATGAATAA -> CGTAGTGCTGATGAATAAG
GATCCTCTCGGTTTGAACC -> ATCCTCTCGGTTTGAACCG
CCGGTTTGAGGCCCAGAAT -> CGGTTTGAGGCCCAGAATG
TCAATGCGCTAGCCGGGAC -> CAATGCGCTAGCCGGGACG
CGCCGTAAACTTGCGTGTC -> GCCGTAAACTTGCGTGTCA
TCTACTCTTTCAGATGGCC -> CTACTCTTTCAGATGGCCA
CTCGCGATTCGAGGCCGGA -> TCGCGATTCGAGGCCGGAA
CCACTTTTACAGGGGCCTT -> CACTTTTACAGGGGCCTTT
TGGGAGTAAGATGGTCATG -> GGGAGTAAGATGGTCATGG
CTCCGCGTGTTTGCTTATG -> TCCGCGTGTTTGCTTATGT
GGCCTTGCAGTAGCGGTGG -> GCCTTGCAGTAGCGGTGGC
CTCGGACTTTGAGGCGAGT -> TCGGACTTTGAGGCGAGTA
ACTAACCGTCATTTATTTA -> CTAACCGTCATTTATTTAT
GGCGGGAGGAAATCGGGAC -> GCGGGAGGAAATCGGGACA
GTATTATTAAAGTCGTTTA -> TATTATTAAAGTCGTTTAG
AGGGATAACGCTCCACTGA -> GGGATAACGCTCCACTGAA
GAAAGGTTAGCAACAACCG -> AAAGGTTAGCAACAACCGT
CTGTGCTGCGTCATAATTT -> TGTGCTGCGTCATAATTTC
CCCCGGTTTACAAATCGTG -> CCCGGTTTACAAATCGTGA
TACAAATCGTGAGTCTTTG -> ACAAATCGTGAGTCTTTGT
TTAGATTTCCTATCTGCCA -> TAGATTTCCTATCTGCCAC
ACTCTTCGAAGATCGTATT -> CTCTTCGAAGATCGTATTT
AGGCGAGTACTTGAATTGT -> GGCGAGTACTTGAATTGTT
GGGAACCCGGTCCAATAAT -> GGAACCCGGTCCAATAATC
GCCCGCTTGTTGGCCCGCC -> CCCGCTTGTTGGCCCGCCA
GGTAGGGGAACCCGGTCCA -> GTAGGGGAACCCGGTCCAA
ATGGATCTTTCTCTGGTGC -> TGGATCTTTCTCTGGTGCA
CAGGAATGTCGCAGCAGTA -> AGGAATGTCGCAGCAGTAA
GACGTGGCATGAACATTTA -> ACGTGGCATGAACATTTAT
CACTTGATGTCTCATCCAT -> ACTTGATGTCTCATCCATG
TGAGTCTTTGTGGTACATG -> GAGTCTTTGTGGTACATGG
CGTACTCTCGGACTTTGAG -> GTACTCTCGGACTTTGAGG
GTTTAGTCGACTGGATCCT -> TTTAGTCGACTGGATCCTC
CAGGGCCTACAATCACAAC -> AGGGCCTACAATCACAACT
GCCAGAATTTTAATCCCGG -> CCAGAATTTTAATCCCGGT
TTATTAAAGTCGTTTAGTC -> TATTAAAGTCGTTTAGTCG
AAATCGTGAGTCTTTGTGG -> AATCGTGAGTCTTTGTGGT
TCGGTTTGAACCGTGAATC -> CGGTTTGAACCGTGAATCC
TCAGATGGCCATGCGGTAT -> CAGATGGCCATGCGGTATC
TCCACAACCAGGACGACCC -> CCACAACCAGGACGACCCC
CTCTCTCCGCGTGTTTGCT -> TCTCTCCGCGTGTTTGCTT
CCCTGTTGACCGAAAGTAA -> CCTGTTGACCGAAAGTAAG
GAAGGACAGTACTTAAATA -> AAGGACAGTACTTAAATAC
GTAAGTATGTATATCATGT -> TAAGTATGTATATCATGTA
AATTTCGTGCATGTTTAGG -> ATTTCGTGCATGTTTAGGC
GATGCTGGTGGCCTTGCAG -> ATGCTGGTGGCCTTGCAGT
GGCAAATAAACACCACTAG -> GCAAATAAACACCACTAGT
CCAGGAGTACGGTATCCCA -> CAGGAGTACGGTATCCCAT
ACCCCCGGTTTACAAATCG -> CCCCCGGTTTACAAATCGT
CAGGCATTTTAGACCACGC -> AGGCATTTTAGACCACGCC
ACACAGCCACGCGAGCTGG -> CACAGCCACGCGAGCTGGG
AGCTTGGGACTGCGGGCTA -> GCTTGGGACTGCGGGCTAT
AAGTCTCCCGAAAAGCCCG -> AGTCTCCCGAAAAGCCCGC
GAACACTTGTCGGGCTGTA -> AACACTTGTCGGGCTGTAG
CTTCAGTGGGTAAGGCCAA -> TTCAGTGGGTAAGGCCAAG
ATTTATAACCCCGAAGATG -> TTTATAACCCCGAAGATGC
CCCGCTTGTTGGCCCGCCA -> CCGCTTGTTGGCCCGCCAC
AATGATCCCCTCCTGCGGA -> ATGATCCCCTCCTGCGGAG
TACCGCTGCCGAGGTCTAA -> ACCGCTGCCGAGGTCTAAG
AGTAAACACAGCCACGCGA -> GTAAACACAGCCACGCGAG
AGTAAGTATGTATATCATG -> GTAAGTATGTATATCATGT
TAGTTCAGGCTAGAAGTAG -> AGTTCAGGCTAGAAGTAGT
AGTCTCCCGAAAAGCCCGC -> GTCTCCCGAAAAGCCCGCG
CCGATTAATGGAGGAATGG -> CGATTAATGGAGGAATGGC
CTCCCTTTGTCGCCGTAAA -> TCCCTTTGTCGCCGTAAAC
AATTTGGGATTATCCCAGG -> ATTTGGGATTATCCCAGGC
TCGAAGTCATACAATGATC -> CGAAGTCATACAATGATCC
AACAGGAATGTCGCAGCAG -> ACAGGAATGTCGCAGCAGT
AACGCTCCACTGAACTCTT -> ACGCTCCACTGAACTCTTC
CGGATGTGTTAGACAAATA -> GGATGTGTTAGACAAATAG
ATTGATGCACCATTTCACT -> TTGATGCACCATTTCACTT
CCAGGGCCTACAATCACAA -> CAGGGCCTACAATCACAAC
TTTCTCGGCGAGGGATAAC -> TTCTCGGCGAGGGATAACG
CTTAAACTTTGATAGCCGC -> TTAAACTTTGATAGCCGCT
CGAATTTTATACAAGTACC -> GAATTTTATACAAGTACCG
AGAATCGTCACACCCCCGT -> GAATCGTCACACCCCCGTC
CCGAGGCTAGCCACTGAAA -> CGAGGCTAGCCACTGAAAG
AAGTGCGACCCATGAATAT -> AGTGCGACCCATGAATATA
TTTTAGACCACGCCCTGTT -> TTTAGACCACGCCCTGTTG
AGGGCCTACAATCACAACT -> GGGCCTACAATCACAACTG
TGAATAAGCTAGAGACCAC -> GAATAAGCTAGAGACCACT
GCGCTAGCCGGGACGTGGC -> CGCTAGCCGGGACGTGGCA
CCCTATTCTAAATATAGCG -> CCTATTCTAAATATAGCGA
TTCCGGCAGAGCCACGCGA -> TCCGGCAGAGCCACGCGAG
GTACATGGCCACTAATTGT -> TACATGGCCACTAATTGTC
GTATCGGTACTGGGAAGGA -> TATCGGTACTGGGAAGGAC
GTGGCCTTGCAGTAGCGGT -> TGGCCTTGCAGTAGCGGTG
ATTAGGTTACACCATCTTA -> TTAGGTTACACCATCTTAG
TGGCCATGCGGTATCGGTA -> GGCCATGCGGTATCGGTAC
TACTCTTTCAGATGGCCAT -> ACTCTTTCAGATGGCCATG
GTATCCCATTGATGCACCA -> TATCCCATTGATGCACCAT
GTGAATCCGGCGGGAGGAA -> TGAATCCGGCGGGAGGAAA
ATGTACGGCAGTACGTCCC -> TGTACGGCAGTACGTCCCT
TAGCTGTAGTTCAGGCTAG -> AGCTGTAGTTCAGGCTAGA
TTAATCAATTACGCCAGAA -> TAATCAATTACGCCAGAAT
CGTAGCCCACTTTTACAGG -> GTAGCCCACTTTTACAGGG
GAGCAGTCGCAAGAATCGT -> AGCAGTCGCAAGAATCGTC
CGAAGTCATACAATGATCC -> GAAGTCATACAATGATCCC
GACTGGATCCTCTCGGTTT -> ACTGGATCCTCTCGGTTTG
CCGCTGCCGAGGTCTAAGT -> CGCTGCCGAGGTCTAAGTA
TAACGCATGGAGAAATGCC -> AACGCATGGAGAAATGCCG
GAGGAATGGCAAATAAACA -> AGGAATGGCAAATAAACAC
TCTCAATGCGCTAGCCGGG -> CTCAATGCGCTAGCCGGGA
GTGAGAACTTGGCTTAAAC -> TGAGAACTTGGCTTAAACT
AGGCTAGAAGTAGTATTAT -> GGCTAGAAGTAGTATTATT
TGGAGAAATGCCGTGTGAT -> GGAGAAATGCCGTGTGATT
AGGGAATCTAATATAATTG -> GGGAATCTAATATAATTGC
AAGTTTCTTCATTAAAGGG -> AGTTTCTTCATTAAAGGGA
TGAATTGTTTAATCAATTA -> GAATTGTTTAATCAATTAC
TCCTCTCGGTTTGAACCGT -> CCTCTCGGTTTGAACCGTG
CGGGCTGTAGCACGAATTT -> GGGCTGTAGCACGAATTTT
TAGTCTGGGTAAGGCCAAG -> AGTCTGGGTAAGGCCAAGG
GAGAAATGACTAACCGTCA -> AGAAATGACTAACCGTCAT
CGACCCATGAATATAAGCC -> GACCCATGAATATAAGCCA
TGCCGAACAACCCCGAGGG -> GCCGAACAACCCCGAGGGC
ACTTGAATTGTTTAATCAA -> CTTGAATTGTTTAATCAAT
TGCGGTATCGGTACTGGGA -> GCGGTATCGGTACTGGGAA
CTGGGAGAGGCTTAATTTG -> TGGGAGAGGCTTAATTTGG
CAGGGGCCTTTCCTGAGGG -> AGGGGCCTTTCCTGAGGGA
CATTTATTTATGGATCTTT -> ATTTATTTATGGATCTTTC
TCGGGACACAAGTGCGACC -> CGGGACACAAGTGCGACCC
GCCGAACAACCCCGAGGGC -> CCGAACAACCCCGAGGGCA
TAATCCGACTACATAGCTG -> AATCCGACTACATAGCTGA
GCTGCCGAGGCTAGCCACT -> CTGCCGAGGCTAGCCACTG
GATCTGCTCTCCCAGGAGT -> ATCTGCTCTCCCAGGAGTA
ACAACCCCGAGGGCAGATT -> CAACCCCGAGGGCAGATTC
TGCGTGTCACATTCGAAGT -> GCGTGTCACATTCGAAGTT
CGCGAGCTGGGAGATTCCC -> GCGAGCTGGGAGATTCCCT
GAAATCGGGACACAAGTGC -> AAATCGGGACACAAGTGCG
CACCCCCGGTTTACAAATC -> ACCCCCGGTTTACAAATCG
TATGGGTAGGGGAACCCGG -> ATGGGTAGGGGAACCCGGT
CTGCGCTCGGATGTGTTAG -> TGCGCTCGGATGTGTTAGA
ACCGTAGCCCACTTTTACA -> CCGTAGCCCACTTTTACAG
CGCGATTCGAGGCCGGAAG -> GCGATTCGAGGCCGGAAGA
CGTGTAGTGCTAGCCTGAC -> GTGTAGTGCTAGCCTGACT
CTCAACCAGAGATTCTGCA -> TCAACCAGAGATTCTGCAA
CCGCGTGTTTGCTTATGTA -> CGCGTGTTTGCTTATGTAC
ACCACTAATCCGACTACAT -> CCACTAATCCGACTACATA
GAAACAGGTATTCCGGCAG -> AAACAGGTATTCCGGCAGA
AGTACTTGAATTGTTTAAT -> GTACTTGAATTGTTTAATC
GCTTTGTGAGTTCTGCGCT -> CTTTGTGAGTTCTGCGCTC
TATGGATCTTTCTCTGGTG -> ATGGATCTTTCTCTGGTGC
TCGGACTTTGAGGCGAGTA -> CGGACTTTGAGGCGAGTAC
ATGGTCATGGGTAAGGCCA -> TGGTCATGGGTAAGGCCAA
ACGATAGTACTCGCGATTC -> CGATAGTACTCGCGATTCG
GAGTTCTGCGCTCGGATGT -> AGTTCTGCGCTCGGATGTG
CTGGCCTCTCTCCGCGTGT -> TGGCCTCTCTCCGCGTGTT
ACCGTCAGTGGGTAAGGCC -> CCGTCAGTGGGTAAGGCCA
AGGACGCTATCCCTGCGCC -> GGACGCTATCCCTGCGCCT
CCGTAGTACCAGGGCCTAC -> CGTAGTACCAGGGCCTACA
GGGGCCTTTCCTGAGGGAA -> GGGCCTTTCCTGAGGGAAT
GCCCCTCTCAATGCGCTAG -> CCCCTCTCAATGCGCTAGC
ACATAGCTGACGATAGTAC -> CATAGCTGACGATAGTACT
TGAGGGCTGCCGAGGCTAG -> GAGGGCTGCCGAGGCTAGC
TGACAGAGAAATGACTAAC -> GACAGAGAAATGACTAACC
GCTCAGCCCGTAACGCATG -> CTCAGCCCGTAACGCATGG
TAGAGACCACTAATCCGAC -> AGAGACCACTAATCCGACT
CAATTGGTAATACCGCCAA -> AATTGGTAATACCGCCAAT
GGTGCAGTAAACACAGCCA -> GTGCAGTAAACACAGCCAC
ATGAATAAGCTAGAGACCA -> TGAATAAGCTAGAGACCAC
TTCTCTGGTGCAGTAAACA -> TCTCTGGTGCAGTAAACAC
TCCAGCTGGGGTGAGAACT -> CCAGCTGGGGTGAGAACTT
TGAAGGGGGCCTATCGTAT -> GAAGGGGGCCTATCGTATC
GTGTTTGCTTATGTACGGC -> TGTTTGCTTATGTACGGCA
GGCCACTAATTGTCCTGGG -> GCCACTAATTGTCCTGGGA
GAAGGGGGCCTATCGTATC -> AAGGGGGCCTATCGTATCT
GCGAGTACTTGAATTGTTT -> CGAGTACTTGAATTGTTTA
CTAGAGACCACTAATCCGA -> TAGAGACCACTAATCCGAC
GAATTCTCGCCGTAGTACC -> AATTCTCGCCGTAGTACCA
TAGTGCTTTGTGAGTTCTG -> AGTGCTTTGTGAGTTCTGC
AAATTATCCCGACACTTCC -> AATTATCCCGACACTTCCA
AAAAGCCCGCGTTCAGAGA -> AAAGCCCGCGTTCAGAGAT
CGGAATTCTCGCCGTAGTA -> GGAATTCTCGCCGTAGTAC
ACCACTAGTACTCGCTGCC -> CCACTAGTACTCGCTGCCG
TGACGATAGTACTCGCGAT -> GACGATAGTACTCGCGATT
ATGATCCCCTCCTGCGGAG -> TGATCCCCTCCTGCGGAGA
TTCCACAAACCGATCCAGG -> TCCACAAACCGATCCAGGA
GCTTGTTGGCCCGCCACCC -> CTTGTTGGCCCGCCACCCC
AGGCTAGCCACTGAAAGGT -> GGCTAGCCACTGAAAGGTT
CCACGCGAGCTGGGAGTAA -> CACGCGAGCTGGGAGTAAG
GTAGCCCACTTTTACAGGG -> TAGCCCACTTTTACAGGGG
AGGTTACACCATCTTAGAT -> GGTTACACCATCTTAGATT
TAAACACCACTAGTACTCG -> AAACACCACTAGTACTCGC
CGGGCTATCTGAAAACTAA -> GGGCTATCTGAAAACTAAT
GACGCACCCCGTATGGCTC -> ACGCACCCCGTATGGCTCA
GATCCAGGACCCTATTCTA -> ATCCAGGACCCTATTCTAA
CGTGAATCCGGCGGGAGGA -> GTGAATCCGGCGGGAGGAA
CTGAAGGGGGCCTATCGTA -> TGAAGGGGGCCTATCGTAT
CACTTCCAGCTGGGGTGAG -> ACTTCCAGCTGGGGTGAGA
TACATAGCTGACGATAGTA -> ACATAGCTGACGATAGTAC
CGCCACCCCCGGTTTACAA -> GCCACCCCCGGTTTACAAA
CTCTTTCAGATGGCCATGC -> TCTTTCAGATGGCCATGCG
TGGTAATACCGCCAATAAG -> GGTAATACCGCCAATAAGT
CACTCCATTTCAAGACGTA -> ACTCCATTTCAAGACGTAG
ACTAGTACTCGCTGCCGAA -> CTAGTACTCGCTGCCGAAC
GGAGTACGGTATCCCATTG -> GAGTACGGTATCCCATTGA
CTAATATAATTGCCGATTA -> TAATATAATTGCCGATTAA
GCGGTATCGGTACTGGGAA -> CGGTATCGGTACTGGGAAG
GTAGCACGAATTTTATACA -> TAGCACGAATTTTATACAA
CCGGGACGTGGCATGAACA -> CGGGACGTGGCATGAACAT
CCGACTACATAGCTGACGA -> CGACTACATAGCTGACGAT
TTACAATTGGTAATACCGC -> TACAATTGGTAATACCGCC
ACCCCGAGGGCAGATTCAG -> CCCCGAGGGCAGATTCAGT
CTGTGCATACTCAACCAGA -> TGTGCATACTCAACCAGAG
GCGGAGATTAGGTTACACC -> CGGAGATTAGGTTACACCA
TGCCACTTCCAGCTGGGGT -> GCCACTTCCAGCTGGGGTG
GCAACCTACACGTGTAGTG -> CAACCTACACGTGTAGTGC
GTTTAGGCGGATCGCATGT -> TTTAGGCGGATCGCATGTG
GTAGTTCAGGCTAGAAGTA -> TAGTTCAGGCTAGAAGTAG
TCCTGGGAGAGGCTTAATT -> CCTGGGAGAGGCTTAATTT
TAGTACTCGCTGCCGAACA -> AGTACTCGCTGCCGAACAA
GACCACTAATCCGACTACA -> ACCACTAATCCGACTACAT
CGTGCCTGTCCTATACCCA -> GTGCCTGTCCTATACCCAT
AATGCGCTAGCCGGGACGT -> ATGCGCTAGCCGGGACGTG
TCTGGCTGGAAATGTAATG -> CTGGCTGGAAATGTAATGA
GAGGCGAGTACTTGAATTG -> AGGCGAGTACTTGAATTGT
AAGTACCGTGGAGAGGTAT -> AGTACCGTGGAGAGGTATG
TAGAAGTAGTATTATTAAA -> AGAAGTAGTATTATTAAAG
GTAAAACTGCTTGAAGAAA -> TAAAACTGCTTGAAGAAAT
CCAAGTATCTGTGCTGCGT -> CAAGTATCTGTGCTGCGTC
GATTAGGTTACACCATCTT -> ATTAGGTTACACCATCTTA
TAAGCCACGCGAGCTGGGA -> AAGCCACGCGAGCTGGGAG
GTCGACTGGATCCTCTCGG -> TCGACTGGATCCTCTCGGT
TGCTGGTGGCCTTGCAGTA -> GCTGGTGGCCTTGCAGTAG
TCGCCGTAAACTTGCGTGT -> CGCCGTAAACTTGCGTGTC
AGATTCTGCAATACGTGCG -> GATTCTGCAATACGTGCGT
AAGACGTAGTGCTGATGAA -> AGACGTAGTGCTGATGAAT
CGCTGCCGAACAACCCCGA -> GCTGCCGAACAACCCCGAG
CGTTTAGTCGACTGGATCC -> GTTTAGTCGACTGGATCCT
GGACTTTGAGGCGAGTACT -> GACTTTGAGGCGAGTACTT
AGTATTATTAAAGTCGTTT -> GTATTATTAAAGTCGTTTA
GGTAAGGCCAAGGACGCTA -> GTAAGGCCAAGGACGCTAT
ATCCGGCGGGAGGAAATCG -> TCCGGCGGGAGGAAATCGG
GCGTGTCACATTCGAAGTT -> CGTGTCACATTCGAAGTTT
GCAGTAAGTGCCACTCCGG -> CAGTAAGTGCCACTCCGGC
GGTAAGGCCAAGGACGCTT -> GTAAGGCCAAGGACGCTTA
GAACATTTATAACCCCGAA -> AACATTTATAACCCCGAAG
CGAACAGGAATGTCGCAGC -> GAACAGGAATGTCGCAGCA
GGCCCAGAATGAGGGCTGC -> GCCCAGAATGAGGGCTGCC
CAAGGACGCAGGCATTTTA -> AAGGACGCAGGCATTTTAG
TTAAGCCCGCTGTGCATAC -> TAAGCCCGCTGTGCATACT
GCCTGTCGAAGTCATACAA -> CCTGTCGAAGTCATACAAT
TGCTTATGTACGGCAGTAC -> GCTTATGTACGGCAGTACG
TCGTCACACCCCCGTCTTA -> CGTCACACCCCCGTCTTAC
GATGCGCGGCAACCTACAC -> ATGCGCGGCAACCTACACG
TAGGCGGATCGCATGTGAT -> AGGCGGATCGCATGTGATG
AAGAAATGGTATGGGTAGG -> AGAAATGGTATGGGTAGGG
TCATAATTTCGTGCATGTT -> CATAATTTCGTGCATGTTT
AATATAGCGAAGCCCGCTT -> ATATAGCGAAGCCCGCTTG
GCATACTCAACCAGAGATT -> CATACTCAACCAGAGATTC
GTCATAATTTCGTGCATGT -> TCATAATTTCGTGCATGTT
AATAATCTACTCTTTCAGA -> ATAATCTACTCTTTCAGAT
GTTTCTTCATTAAAGGGAA -> TTTCTTCATTAAAGGGAAG
CCGACACTTCCACAAACCG -> CGACACTTCCACAAACCGA
TTTCTCTGGTGCAGTAAAC -> TTCTCTGGTGCAGTAAACA
CGTGGCATGAACATTTATA -> GTGGCATGAACATTTATAA
AAGGACCCACCACAGCTTG -> AGGACCCACCACAGCTTGG
CCACAACCAGGACGACCCC -> CACAACCAGGACGACCCCG
GGAGCCAAATTAGTCTGGG -> GAGCCAAATTAGTCTGGGT
TTTAATCCCGGTTTGAGGC -> TTAATCCCGGTTTGAGGCC
TTTCCTGAGGGAATCTAAT -> TTCCTGAGGGAATCTAATA
GGCAACCTACACGTGTAGT -> GCAACCTACACGTGTAGTG
TCCACAAACCGATCCAGGA -> CCACAAACCGATCCAGGAC
CAGTACTTAAATACGTACG -> AGTACTTAAATACGTACGG
CGCGAGCTGGGAGGTGACC -> GCGAGCTGGGAGGTGACCG
GTAGCCACGCGAGCTGGGA -> TAGCCACGCGAGCTGGGAG
TTTTGAGCCCCTCTCAATG -> TTTGAGCCCCTCTCAATGC
GTCTCCCGAAAAGCCCGCG -> TCTCCCGAAAAGCCCGCGT
GAGTACTTGAATTGTTTAA -> AGTACTTGAATTGTTTAAT
CTTGAAGAAATGGTATGGG -> TTGAAGAAATGGTATGGGT
GTCTGGGTAAGGCCAAGGA -> TCTGGGTAAGGCCAAGGAC
CAGTGGGTAAGGCCAAGGA -> AGTGGGTAAGGCCAAGGAC,AGTGGGTAAGGCCAAGGAC
ACATGGCCACTAATTGTCC -> CATGGCCACTAATTGTCCT
AGATTTCCTATCTGCCACT -> GATTTCCTATCTGCCACTT
CAGATGGCCATGCGGTATC -> AGATGGCCATGCGGTATCG
GTAGTACCAGGGCCTACAA -> TAGTACCAGGGCCTACAAT
CTTTGTGGTACATGGCCAC -> TTTGTGGTACATGGCCACT
ATTTGGGATTATCCCAGGC -> TTTGGGATTATCCCAGGCC
ACTTGGCTTAAACTTTGAT -> CTTGGCTTAAACTTTGATA
CCAAGGACGCAGGCATTTT -> CAAGGACGCAGGCATTTTA
ACGGATCTGCTCTCCCAGG -> CGGATCTGCTCTCCCAGGA
TCTTACAATTGGTAATACC -> CTTACAATTGGTAATACCG
AGGACGCTTAGCCAGCGTC -> GGACGCTTAGCCAGCGTCG
CACACCCCCGTCTTACAAT -> ACACCCCCGTCTTACAATT
TGATAGCCGCTGACAGAGA -> GATAGCCGCTGACAGAGAA
AATGTCCACAACCAGGACG -> ATGTCCACAACCAGGACGA
GGGAAGGACCCACCACAGC -> GGAAGGACCCACCACAGCT
GACAGAGAAATGACTAACC -> ACAGAGAAATGACTAACCG
AAGCCCGCTTGTTGGCCCG -> AGCCCGCTTGTTGGCCCGC
AAGGTTAGCAACAACCGTG -> AGGTTAGCAACAACCGTGC
CATGCGGTATCGGTACTGG -> ATGCGGTATCGGTACTGGG
CAGAGATGTCGAGAAACAC -> AGAGATGTCGAGAAACACG
CGAAGATCGTATTTAGTTG -> GAAGATCGTATTTAGTTGA
AGGGAAGATCTAAGACTCA -> GGGAAGATCTAAGACTCAC
TTCCAGCTGGGGTGAGAAC -> TCCAGCTGGGGTGAGAACT
ACGGAATTCTCGCCGTAGT -> CGGAATTCTCGCCGTAGTA
GAGGCTTAATTTGGGATTA -> AGGCTTAATTTGGGATTAT
TCCAATAATCTACTCTTTC -> CCAATAATCTACTCTTTCA
TAGACAAATAGCTGTAGTT -> AGACAAATAGCTGTAGTTC
CAGAGATTCTGCAATACGT -> AGAGATTCTGCAATACGTG
CACAAACCGATCCAGGACC -> ACAAACCGATCCAGGACCC
CAAACCGATCCAGGACCCT -> AAACCGATCCAGGACCCTA
TTTAATCAATTACGCCAGA -> TTAATCAATTACGCCAGAA
AATCAATTACGCCAGAATT -> ATCAATTACGCCAGAATTT
ACACCATCTTAGATTTCCT -> CACCATCTTAGATTTCCTA
CCTACACGTGTAGTGCTAG -> CTACACGTGTAGTGCTAGC
GACTCACTCCATTTCAAGA -> ACTCACTCCATTTCAAGAC
AAAGGGAAGATCTAAGACT -> AAGGGAAGATCTAAGACTC
GTAAGGCCAAGGACGCTTA -> TAAGGCCAAGGACGCTTAG
CCTCTCTCCGCGTGTTTGC -> CTCTCTCCGCGTGTTTGCT
AATGCCGTGTGATTCTTAC -> ATGCCGTGTGATTCTTACG
ACCGCTGCCGAGGTCTAAG -> CCGCTGCCGAGGTCTAAGT
GAACAACCCCGAGGGCAGA -> AACAACCCCGAGGGCAGAT
TACGGTATCCCATTGATGC -> ACGGTATCCCATTGATGCA
AGTTGATTCTGGCCTCTCT -> GTTGATTCTGGCCTCTCTC
AACACAGCCACGCGAGCTG -> ACACAGCCACGCGAGCTGG
TCCAGGACCCTATTCTAAA -> CCAGGACCCTATTCTAAAT
CCCACCACAGCTTGGGACT -> CCACCACAGCTTGGGACTG
AGGGGGCCTATCGTATCTT -> GGGGGCCTATCGTATCTTG
TCGGGCTGTAGCACGAATT -> CGGGCTGTAGCACGAATTT
AACATTTATAACCCCGAAG -> ACATTTATAACCCCGAAGA
TGCGCCTGTCGAAGTCATA -> GCGCCTGTCGAAGTCATAC
CGACACTTCCACAAACCGA -> GACACTTCCACAAACCGAT
ACAGGGACGCAAACGGAAT -> CAGGGACGCAAACGGAATT
ATCCCGACACTTCCACAAA -> TCCCGACACTTCCACAAAC
AAACACAGCCACGCGAGCT -> AACACAGCCACGCGAGCTG
GTAGCGGTGGCAAATTATC -> TAGCGGTGGCAAATTATCC
ATTTATGGATCTTTCTCTG -> TTTATGGATCTTTCTCTGG
CTGGTGGCCTTGCAGTAGC -> TGGTGGCCTTGCAGTAGCG
ATATAATTGCCGATTAATG -> TATAATTGCCGATTAATGG
TTCTTCATTAAAGGGAAGA -> TCTTCATTAAAGGGAAGAT
GATGTGTTAGACAAATAGC -> ATGTGTTAGACAAATAGCT
ATGAGCTTGCACGCGCGGT -> TGAGCTTGCACGCGCGGTT
CGCTGACAGAGAAATGACT -> GCTGACAGAGAAATGACTA
CTGATGAATAAGCTAGAGA -> TGATGAATAAGCTAGAGAC
CTGAAAACTAATGTCCACA -> TGAAAACTAATGTCCACAA
TATCTTGGTAGCCACGCGA -> ATCTTGGTAGCCACGCGAG
TTCACTTGATGTCTCATCC -> TCACTTGATGTCTCATCCA
GAGCCCCCAAGTATCTGTG -> AGCCCCCAAGTATCTGTGC
CCACGCGAGCTGGGAGATT -> CACGCGAGCTGGGAGATTC
CCTGTCCTATACCCATGCA -> CTGTCCTATACCCATGCAC
GCTTAAACTTTGATAGCCG -> CTTAAACTTTGATAGCCGC
TGCTTGAAGAAATGGTATG -> GCTTGAAGAAATGGTATGG
AATTGTTTAATCAATTACG -> ATTGTTTAATCAATTACGC
TCTTTGTGGTACATGGCCA -> CTTTGTGGTACATGGCCAC
CCCACTTTTACAGGGGCCT -> CCACTTTTACAGGGGCCTT
CTTGGTAGCCACGCGAGCT -> TTGGTAGCCACGCGAGCTG
CGTAGTACCAGGGCCTACA -> GTAGTACCAGGGCCTACAA
GGAATCTAATATAATTGCC -> GAATCTAATATAATTGCCG
GCCAGCGTCGGACTTTCTC -> CCAGCGTCGGACTTTCTCG
CGTTCAGAGATGTCGAGAA -> GTTCAGAGATGTCGAGAAA
CCACTTCCAGCTGGGGTGA -> CACTTCCAGCTGGGGTGAG
AGTACGGTATCCCATTGAT -> GTACGGTATCCCATTGATG
TAGATTTCCTATCTGCCAC -> AGATTTCCTATCTGCCACT
TGCTGATGAATAAGCTAGA -> GCTGATGAATAAGCTAGAG
GGAGGAAATCGGGACACAA -> GAGGAAATCGGGACACAAG
ACAACCAGGACGACCCCGC -> CAACCAGGACGACCCCGCG
CCTCCTGCGGAGATTAGGT -> CTCCTGCGGAGATTAGGTT
CTTGCACGCGCGGTTTTTT -> TTGCACGCGCGGTTTTTTG
ATTTAGTTGATTCTGGCCT -> TTTAGTTGATTCTGGCCTC
ACACGCGCGGTACCGTACT -> CACGCGCGGTACCGTACTC
CTGCGCCTGTCGAAGTCAT -> TGCGCCTGTCGAAGTCATA
CGTATGGCTCAGCCCGTAA -> GTATGGCTCAGCCCGTAAC
GTACTTGAATTGTTTAATC -> TACTTGAATTGTTTAATCA
TTGTGAGTTCTGCGCTCGG -> TGTGAGTTCTGCGCTCGGA
CGAAGATGCGCGGCAACCT -> GAAGATGCGCGGCAACCTA
GGTACTGGGAAGGACCCAC -> GTACTGGGAAGGACCCACC
TTAATCCCGGTTTGAGGCC -> TAATCCCGGTTTGAGGCCC
GTACTCGCTGCCGAACAAC -> TACTCGCTGCCGAACAACC
TCCGACTACATAGCTGACG -> CCGACTACATAGCTGACGA
ATGCGCTAGCCGGGACGTG -> TGCGCTAGCCGGGACGTGG
TTTAGTTGATTCTGGCCTC -> TTAGTTGATTCTGGCCTCT
CCCGTCTTACAATTGGTAA -> CCGTCTTACAATTGGTAAT
TGTAAGCGTCCCGCTGAAG -> GTAAGCGTCCCGCTGAAGG
ACTGGGAAGGACCCACCAC -> CTGGGAAGGACCCACCACA
CTCTCGGTTTGAACCGTGA -> TCTCGGTTTGAACCGTGAA
GAGACCACTAATCCGACTA -> AGACCACTAATCCGACTAC
AACACGCGCGGTACCGTAC -> ACACGCGCGGTACCGTACT
TGCGCTCGGATGTGTTAGA -> GCGCTCGGATGTGTTAGAC
GCCTGACTCCCTTTGTCGC -> CCTGACTCCCTTTGTCGCC
GTGCATACTCAACCAGAGA -> TGCATACTCAACCAGAGAT
CGCGTTCAGAGATGTCGAG -> GCGTTCAGAGATGTCGAGA
TGGGACTGCGGGCTATCTG -> GGGACTGCGGGCTATCTGA
TCTTTCAGATGGCCATGCG -> CTTTCAGATGGCCATGCGG
AAGTGCCACTCCGGCGAGC -> AGTGCCACTCCGGCGAGCC
GGCCTTTCCTGAGGGAATC -> GCCTTTCCTGAGGGAATCT
AGTAGTATTATTAAAGTCG -> GTAGTATTATTAAAGTCGT
TAGGTTACACCATCTTAGA -> AGGTTACACCATCTTAGAT
CGAACAACCCCGAGGGCAG -> GAACAACCCCGAGGGCAGA
AATCTAATATAATTGCCGA -> ATCTAATATAATTGCCGAT
TTTCCTATCTGCCACTTCC -> TTCCTATCTGCCACTTCCA
GCCTATCGTATCTTGGTAG -> CCTATCGTATCTTGGTAGC
TGGGTAGGGGAACCCGGTC -> GGGTAGGGGAACCCGGTCC
ACAAGTGCGACCCATGAAT -> CAAGTGCGACCCATGAATA
ATTGGTAATACCGCCAATA -> TTGGTAATACCGCCAATAA
CCCCGAAGATGCGCGGCAA -> CCCGAAGATGCGCGGCAAC
TCATACAATGATCCCCTCC -> CATACAATGATCCCCTCCT
TAAGACTCACTCCATTTCA -> AAGACTCACTCCATTTCAA
AAGGACGCTTAGCCAGCGT -> AGGACGCTTAGCCAGCGTC
TCCGGCAGAGCCACGCGAG -> CCGGCAGAGCCACGCGAGC
CGTACGGATCTGCTCTCCC -> GTACGGATCTGCTCTCCCA
TACGGCAGTACGTCCCTGG -> ACGGCAGTACGTCCCTGGC
CAGTCGCAAGAATCGTCAC -> AGTCGCAAGAATCGTCACA
GTAGTATTATTAAAGTCGT -> TAGTATTATTAAAGTCGTT
TCCATTTCAAGACGTAGTG -> CCATTTCAAGACGTAGTGC
AGTACTCGCTGCCGAACAA -> GTACTCGCTGCCGAACAAC
GCATGAACATTTATAACCC -> CATGAACATTTATAACCCC
TAACGCTCCACTGAACTCT -> AACGCTCCACTGAACTCTT
AGCCTGACTCCCTTTGTCG -> GCCTGACTCCCTTTGTCGC
CTGCCGAGGTCTAAGTAGT -> TGCCGAGGTCTAAGTAGTC
GAGAAACACGCGCGGTACC -> AGAAACACGCGCGGTACCG
CTTAATTTGGGATTATCCC -> TTAATTTGGGATTATCCCA
GTGTTAGACAAATAGCTGT -> TGTTAGACAAATAGCTGTA
GAAGATGCGCGGCAACCTA -> AAGATGCGCGGCAACCTAC
CCAGAATTTTAATCCCGGT -> CAGAATTTTAATCCCGGTT
ATCGTCACACCCCCGTCTT -> TCGTCACACCCCCGTCTTA
CCCTCTCAATGCGCTAGCC -> CCTCTCAATGCGCTAGCCG
AGTGCGACCCATGAATATA -> GTGCGACCCATGAATATAA
GCTAGAGACCACTAATCCG -> CTAGAGACCACTAATCCGA
CTTTGAGGCGAGTACTTGA -> TTTGAGGCGAGTACTTGAA
ACCCACCACAGCTTGGGAC -> CCCACCACAGCTTGGGACT
TGTTTAATCAATTACGCCA -> GTTTAATCAATTACGCCAG
AATGACTAACCGTCATTTA -> ATGACTAACCGTCATTTAT
GGGAAGATCTAAGACTCAC -> GGAAGATCTAAGACTCACT
GGCGGATCGCATGTGATGC -> GCGGATCGCATGTGATGCT
AACAACCCCGAGGGCAGAT -> ACAACCCCGAGGGCAGATT
GCTGGTGGCCTTGCAGTAG -> CTGGTGGCCTTGCAGTAGC
GCGCTCGGATGTGTTAGAC -> CGCTCGGATGTGTTAGACA
AATACGTGCGTCTGAAACA -> ATACGTGCGTCTGAAACAG
CAGGACCCTATTCTAAATA -> AGGACCCTATTCTAAATAT
ACACCCCCGTCTTACAATT -> CACCCCCGTCTTACAATTG
GGGACTGCGGGCTATCTGA -> GGACTGCGGGCTATCTGAA
GAATGAGGGCTGCCGAGGC -> AATGAGGGCTGCCGAGGCT
ATCGGTACTGGGAAGGACC -> TCGGTACTGGGAAGGACCC
GGTTTACAAATCGTGAGTC -> GTTTACAAATCGTGAGTCT
CATTGATGCACCATTTCAC -> ATTGATGCACCATTTCACT
GATAGTACTCGCGATTCGA -> ATAGTACTCGCGATTCGAG
ATTTCACTTGATGTCTCAT -> TTTCACTTGATGTCTCATC
GTACTGGGAAGGACCCACC -> TACTGGGAAGGACCCACCA
GGGACACAAGTGCGACCCA -> GGACACAAGTGCGACCCAT
TGCCGATTAATGGAGGAAT -> GCCGATTAATGGAGGAATG
CTAAGACTCACTCCATTTC -> TAAGACTCACTCCATTTCA
CCAGGACCCTATTCTAAAT -> CAGGACCCTATTCTAAATA
GAGGCCGGAAGAGCAGTCG -> AGGCCGGAAGAGCAGTCGC
ATCCGACTACATAGCTGAC -> TCCGACTACATAGCTGACG
ATAATTTCGTGCATGTTTA -> TAATTTCGTGCATGTTTAG
GTGTAGTGCTAGCCTGACT -> TGTAGTGCTAGCCTGACTC
AACCCCGAAGATGCGCGGC -> ACCCCGAAGATGCGCGGCA
ATTTCCTATCTGCCACTTC -> TTTCCTATCTGCCACTTCC
GGACGCACCCCGTATGGCT -> GACGCACCCCGTATGGCTC
CCCGCCACCCCCGGTTTAC -> CCGCCACCCCCGGTTTACA
GTACTCTCGGACTTTGAGG -> TACTCTCGGACTTTGAGGC
GCCGAGGTCTAAGTAGTCT -> CCGAGGTCTAAGTAGTCTG
CAAGGACGCACCCCGTATG -> AAGGACGCACCCCGTATGG
AGTGCCACTCCGGCGAGCC -> GTGCCACTCCGGCGAGCCC
CCGTAACGCATGGAGAAAT -> CGTAACGCATGGAGAAATG
CCACAGCTTGGGACTGCGG -> CACAGCTTGGGACTGCGGG
GCTGCCGAGGTCTAAGTAG -> CTGCCGAGGTCTAAGTAGT
GCCTGTCCTATACCCATGC -> CCTGTCCTATACCCATGCA
AAGATCTAAGACTCACTCC -> AGATCTAAGACTCACTCCA
TCTCCCGAAAAGCCCGCGT -> CTCCCGAAAAGCCCGCGTT
GGTTACACCATCTTAGATT -> GTTACACCATCTTAGATTT
GGCGAGTACTTGAATTGTT -> GCGAGTACTTGAATTGTTT
TGGATCCTCTCGGTTTGAA -> GGATCCTCTCGGTTTGAAC
ATTATTAAAGTCGTTTAGT -> TTATTAAAGTCGTTTAGTC
ACACCACTAGTACTCGCTG -> CACCACTAGTACTCGCTGC
CAAACGGAATTCTCGCCGT -> AAACGGAATTCTCGCCGTA
AGGAATGTCGCAGCAGTAA -> GGAATGTCGCAGCAGTAAG
GGTACCGTACTCTCGGACT -> GTACCGTACTCTCGGACTT
ACCGTGAATCCGGCGGGAG -> CCGTGAATCCGGCGGGAGG
AGACTCACTCCATTTCAAG -> GACTCACTCCATTTCAAGA
CAATAATCTACTCTTTCAG -> AATAATCTACTCTTTCAGA
GTGCATGTTTAGGCGGATC -> TGCATGTTTAGGCGGATCG
GTGCTGATGAATAAGCTAG -> TGCTGATGAATAAGCTAGA
ACGTGGCATGAACATTTAT -> CGTGGCATGAACATTTATA
TCCACTGAACTCTTCGAAG -> CCACTGAACTCTTCGAAGA
TGTCGAAGTCATACAATGA -> GTCGAAGTCATACAATGAT
CACGCGCGGTTTTTTGAGC -> ACGCGCGGTTTTTTGAGCC
GTCCTGGGAGAGGCTTAAT -> TCCTGGGAGAGGCTTAATT
GCCACTTCCAGCTGGGGTG -> CCACTTCCAGCTGGGGTGA
GACCGTCAGTGGGTAAGGC -> ACCGTCAGTGGGTAAGGCC
CTTAGCCAGCGTCGGACTT -> TTAGCCAGCGTCGGACTTT
TGCCTGTCCTATACCCATG -> GCCTGTCCTATACCCATGC
GACCGAAAGTAAGTATGTA -> ACCGAAAGTAAGTATGTAT
AGCCGGGACGTGGCATGAA -> GCCGGGACGTGGCATGAAC
TGAGCTTGCACGCGCGGTT -> GAGCTTGCACGCGCGGTTT
CCACTAGTACTCGCTGCCG -> CACTAGTACTCGCTGCCGA
TGATTCTGGCCTCTCTCCG -> GATTCTGGCCTCTCTCCGC
TCTCGCCGTAGTACCAGGG -> CTCGCCGTAGTACCAGGGC
TGACTCCCTTTGTCGCCGT -> GACTCCCTTTGTCGCCGTA
TGTCACATTCGAAGTTTCT -> GTCACATTCGAAGTTTCTT
CAGGACGACCCCGCGACAG -> AGGACGACCCCGCGACAGG
CAGTAAACACAGCCACGCG -> AGTAAACACAGCCACGCGA
ACCGATCCAGGACCCTATT -> CCGATCCAGGACCCTATTC
AACTCTTCGAAGATCGTAT -> ACTCTTCGAAGATCGTATT
CCGTAAACTTGCGTGTCAC -> CGTAAACTTGCGTGTCACA
GTATCTGTGCTGCGTCATA -> TATCTGTGCTGCGTCATAA
CAAATCGTGAGTCTTTGTG -> AAATCGTGAGTCTTTGTGG
TTGTCGCCGTAAACTTGCG -> TGTCGCCGTAAACTTGCGT
TGAGAACTTGGCTTAAACT -> GAGAACTTGGCTTAAACTT
CGGTTTGAACCGTGAATCC -> GGTTTGAACCGTGAATCCG
GGGATTATCCCAGGCCCCT -> GGATTATCCCAGGCCCCTT
AGTCTGGGTAAGGCCAAGG -> GTCTGGGTAAGGCCAAGGA
CCTGCGCCTGTCGAAGTCA -> CTGCGCCTGTCGAAGTCAT
TCGCATGTGATGCTGGTGG -> CGCATGTGATGCTGGTGGC
ACGTCCCTGGCCTCCGAAC -> CGTCCCTGGCCTCCGAACA
TTAAATACGTACGGATCTG -> TAAATACGTACGGATCTGC
TACCGCCAATAAGTCTCCC -> ACCGCCAATAAGTCTCCCG
CCCCTCCTGCGGAGATTAG -> CCCTCCTGCGGAGATTAGG
GATCTAAGACTCACTCCAT -> ATCTAAGACTCACTCCATT
TGTCGCCGTAAACTTGCGT -> GTCGCCGTAAACTTGCGTG
TAAACACAGCCACGCGAGC -> AAACACAGCCACGCGAGCT
AGATGGCCATGCGGTATCG -> GATGGCCATGCGGTATCGG
GCTAGCCGGGACGTGGCAT -> CTAGCCGGGACGTGGCATG
AGAACTTGGCTTAAACTTT -> GAACTTGGCTTAAACTTTG
TAGCTGACGATAGTACTCG -> AGCTGACGATAGTACTCGC
ACATTCGAAGTTTCTTCAT -> CATTCGAAGTTTCTTCATT
CCGTAGCCCACTTTTACAG -> CGTAGCCCACTTTTACAGG
CACACCGTAGCCCACTTTT -> ACACCGTAGCCCACTTTTA
GGAACCCGGTCCAATAATC -> GAACCCGGTCCAATAATCT
CCGCTGAAGGACAGTACTT -> CGCTGAAGGACAGTACTTA
TTAGTCGACTGGATCCTCT -> TAGTCGACTGGATCCTCTC
CCTTGCAGTAGCGGTGGCA -> CTTGCAGTAGCGGTGGCAA
CCAATAATCTACTCTTTCA -> CAATAATCTACTCTTTCAG
TGCTTTGTGAGTTCTGCGC -> GCTTTGTGAGTTCTGCGCT
CGTATCTTGGTAGCCACGC -> GTATCTTGGTAGCCACGCG
ATTCTTACGAACACTTGTC -> TTCTTACGAACACTTGTCG
GTCAGTGGGTAAGGCCAAG -> TCAGTGGGTAAGGCCAAGG
TGAACTCTTCGAAGATCGT -> GAACTCTTCGAAGATCGTA
GACTAACCGTCATTTATTT -> ACTAACCGTCATTTATTTA
AGGCCAAGGACGCAGGCAT -> GGCCAAGGACGCAGGCATT
GGCATGAACATTTATAACC -> GCATGAACATTTATAACCC
TCGCAGCAGTAAGTGCCAC -> CGCAGCAGTAAGTGCCACT
CCCGCTGTGCATACTCAAC -> CCGCTGTGCATACTCAACC
GGCAGTACGTCCCTGGCCT -> GCAGTACGTCCCTGGCCTC
CCCTGCGCCTGTCGAAGTC -> CCTGCGCCTGTCGAAGTCA
TAAGGCCAAGGACGCTTAG -> AAGGCCAAGGACGCTTAGC
AGCCCCCAAGTATCTGTGC -> GCCCCCAAGTATCTGTGCT
AGCTGGGAGGTGACCGTCA -> GCTGGGAGGTGACCGTCAG
TTTGTGGTACATGGCCACT -> TTGTGGTACATGGCCACTA
TACGTGCGTCTGAAACAGG -> ACGTGCGTCTGAAACAGGT
CTGAAGGACAGTACTTAAA -> TGAAGGACAGTACTTAAAT
TTAAAGGGAAGATCTAAGA -> TAAAGGGAAGATCTAAGAC
TATTATTAAAGTCGTTTAG -> ATTATTAAAGTCGTTTAGT
AATTAGTCTGGGTAAGGCC -> ATTAGTCTGGGTAAGGCCA
TATAATTGCCGATTAATGG -> ATAATTGCCGATTAATGGA
GGATCTGCTCTCCCAGGAG -> GATCTGCTCTCCCAGGAGT
GTGCTAGCCTGACTCCCTT -> TGCTAGCCTGACTCCCTTT
AGTTCTGCGCTCGGATGTG -> GTTCTGCGCTCGGATGTGT
AAGAGCAGTCGCAAGAATC -> AGAGCAGTCGCAAGAATCG
CGAAGCCCGCTTGTTGGCC -> GAAGCCCGCTTGTTGGCCC
GGCCTATCGTATCTTGGTA -> GCCTATCGTATCTTGGTAG
AGAATTTTAATCCCGGTTT -> GAATTTTAATCCCGGTTTG
ATCTTTCTCTGGTGCAGTA -> TCTTTCTCTGGTGCAGTAA
GTCGGACTTTCTCGGCGAG -> TCGGACTTTCTCGGCGAGG
CGGAGATTAGGTTACACCA -> GGAGATTAGGTTACACCAT
CCGATCCAGGACCCTATTC -> CGATCCAGGACCCTATTCT
CGCGGCAACCTACACGTGT -> GCGGCAACCTACACGTGTA
TAATCTACTCTTTCAGATG -> AATCTACTCTTTCAGATGG
CCCAAGTATCTGTGCTGCG -> CCAAGTATCTGTGCTGCGT
ACTTTGATAGCCGCTGACA -> CTTTGATAGCCGCTGACAG
TAATTGTCCTGGGAGAGGC -> AATTGTCCTGGGAGAGGCT
AGGTATGAGCTTGCACGCG -> GGTATGAGCTTGCACGCGC
TATTCTAAATATAGCGAAG -> ATTCTAAATATAGCGAAGC
ACTACATAGCTGACGATAG -> CTACATAGCTGACGATAGT
TAGTACCAGGGCCTACAAT -> AGTACCAGGGCCTACAATC
CTGTAGTTCAGGCTAGAAG -> TGTAGTTCAGGCTAGAAGT
TCCCAGGAGTACGGTATCC -> CCCAGGAGTACGGTATCCC
TATAGTGCTTTGTGAGTTC -> ATAGTGCTTTGTGAGTTCT
GACAAATAGCTGTAGTTCA -> ACAAATAGCTGTAGTTCAG
GCTTAGCCAGCGTCGGACT -> CTTAGCCAGCGTCGGACTT
TTGCCGATTAATGGAGGAA -> TGCCGATTAATGGAGGAAT
TTAGGTTACACCATCTTAG -> TAGGTTACACCATCTTAGA
CGGGACGTGGCATGAACAT -> GGGACGTGGCATGAACATT
CGAGCCCCCAAGTATCTGT -> GAGCCCCCAAGTATCTGTG
TCACAACTGAAGGGGGCCT -> CACAACTGAAGGGGGCCTA
AAAACTAATGTCCACAACC -> AAACTAATGTCCACAACCA
AGATTCCCTTCAGTGGGTA -> GATTCCCTTCAGTGGGTAA
AGTCGTTTAGTCGACTGGA -> GTCGTTTAGTCGACTGGAT
CGGTACTGGGAAGGACCCA -> GGTACTGGGAAGGACCCAC
TGGCCCGCCACCCCCGGTT -> GGCCCGCCACCCCCGGTTT
TTAGACCACGCCCTGTTGA -> TAGACCACGCCCTGTTGAC
CCTTAAGCCCGCTGTGCAT -> CTTAAGCCCGCTGTGCATA
GTATCTTGGTAGCCACGCG -> TATCTTGGTAGCCACGCGA
AGACAAATAGCTGTAGTTC -> GACAAATAGCTGTAGTTCA
TACTTGAATTGTTTAATCA -> ACTTGAATTGTTTAATCAA
GTTGGCCCGCCACCCCCGG -> TTGGCCCGCCACCCCCGGT
TTTCTTCATTAAAGGGAAG -> TTCTTCATTAAAGGGAAGA
GCCGTGTGATTCTTACGAA -> CCGTGTGATTCTTACGAAC
TAATTTCGTGCATGTTTAG -> AATTTCGTGCATGTTTAGG
CGTATTTAGTTGATTCTGG -> GTATTTAGTTGATTCTGGC
GTCTGAAACAGGTATTCCG -> TCTGAAACAGGTATTCCGG
CTGCTCTCCCAGGAGTACG -> TGCTCTCCCAGGAGTACGG
ACAATTGGTAATACCGCCA -> CAATTGGTAATACCGCCAA
CCCGTATGGCTCAGCCCGT -> CCGTATGGCTCAGCCCGTA
GGTAATACCGCCAATAAGT -> GTAATACCGCCAATAAGTC
GTTCAGAGATGTCGAGAAA -> TTCAGAGATGTCGAGAAAC
GCTGACAGAGAAATGACTA -> CTGACAGAGAAATGACTAA
CTTACAATTGGTAATACCG -> TTACAATTGGTAATACCGC
CTTCCAGCTGGGGTGAGAA -> TTCCAGCTGGGGTGAGAAC
TCTGAAACAGGTATTCCGG -> CTGAAACAGGTATTCCGGC
ATTGCCGATTAATGGAGGA -> TTGCCGATTAATGGAGGAA
TCTTTCTCTGGTGCAGTAA -> CTTTCTCTGGTGCAGTAAA
ATACAAGTACCGTGGAGAG -> TACAAGTACCGTGGAGAGG
AAGTCGTTTAGTCGACTGG -> AGTCGTTTAGTCGACTGGA
TAAATACGTACGGATCTGC -> AAATACGTACGGATCTGCT
AATCGTGAGTCTTTGTGGT -> ATCGTGAGTCTTTGTGGTA
GGGCAGATTCAGTACCGCT -> GGCAGATTCAGTACCGCTG
TCATGGGTAAGGCCAAGGA -> CATGGGTAAGGCCAAGGAC
GTGGTACATGGCCACTAAT -> TGGTACATGGCCACTAATT
ACGGCAGTACGTCCCTGGC -> CGGCAGTACGTCCCTGGCC
CGTCTGAAACAGGTATTCC -> GTCTGAAACAGGTATTCCG
CTTTGTCGCCGTAAACTTG -> TTTGTCGCCGTAAACTTGC
ACAATGATCCCCTCCTGCG -> CAATGATCCCCTCCTGCGG
CGTCGGACTTTCTCGGCGA -> GTCGGACTTTCTCGGCGAG
TAAATATAGCGAAGCCCGC -> AAATATAGCGAAGCCCGCT
TATTTAGTTGATTCTGGCC -> ATTTAGTTGATTCTGGCCT
AAGGACAGTACTTAAATAC -> AGGACAGTACTTAAATACG
ATGCCGTGTGATTCTTACG -> TGCCGTGTGATTCTTACGA
TGATGCACCATTTCACTTG -> GATGCACCATTTCACTTGA
GAAGAGCAGTCGCAAGAAT -> AAGAGCAGTCGCAAGAATC
AACCTACACGTGTAGTGCT -> ACCTACACGTGTAGTGCTA
GGGTAAGGCCAAGGACGCT -> GGTAAGGCCAAGGACGCTA,GGTAAGGCCAAGGACGCTT
GTCTTTGTGGTACATGGCC -> TCTTTGTGGTACATGGCCA
ACGCTCCACTGAACTCTTC -> CGCTCCACTGAACTCTTCG
GAAGCCCGCTTGTTGGCCC -> AAGCCCGCTTGTTGGCCCG
GTGATGCTGGTGGCCTTGC -> TGATGCTGGTGGCCTTGCA
ACCGTGCCTGTCCTATACC -> CCGTGCCTGTCCTATACCC
TTGTCGGGCTGTAGCACGA -> TGTCGGGCTGTAGCACGAA
AGTAGCGGTGGCAAATTAT -> GTAGCGGTGGCAAATTATC
ATGGGTAGGGGAACCCGGT -> TGGGTAGGGGAACCCGGTC
CCGGCAGAGCCACGCGAGC -> CGGCAGAGCCACGCGAGCT
CTGGGAGATTCCCTTCAGT -> TGGGAGATTCCCTTCAGTG
ACCATCTTAGATTTCCTAT -> CCATCTTAGATTTCCTATC
AGCTGTAGTTCAGGCTAGA -> GCTGTAGTTCAGGCTAGAA
CAGAGAAATGACTAACCGT -> AGAGAAATGACTAACCGTC
GCTATCCCTGCGCCTGTCG -> CTATCCCTGCGCCTGTCGA
ACTGCGGGCTATCTGAAAA -> CTGCGGGCTATCTGAAAAC
CGAGGGATAACGCTCCACT -> GAGGGATAACGCTCCACTG
TGAGTTCTGCGCTCGGATG -> GAGTTCTGCGCTCGGATGT
GGACCCACCACAGCTTGGG -> GACCCACCACAGCTTGGGA
TTCTCGCCGTAGTACCAGG -> TCTCGCCGTAGTACCAGGG
TAAGCTAGAGACCACTAAT -> AAGCTAGAGACCACTAATC
GGTCATGGGTAAGGCCAAG -> GTCATGGGTAAGGCCAAGG
TGTGCATACTCAACCAGAG -> GTGCATACTCAACCAGAGA
AAGCCACGCGAGCTGGGAG -> AGCCACGCGAGCTGGGAGA
GAGCTGGGAGATTCCCTTC -> AGCTGGGAGATTCCCTTCA
AAATAGCTGTAGTTCAGGC -> AATAGCTGTAGTTCAGGCT
AATTTTAATCCCGGTTTGA -> ATTTTAATCCCGGTTTGAG
CCCAGGAGTACGGTATCCC -> CCAGGAGTACGGTATCCCA
GCACACCGTAGCCCACTTT -> CACACCGTAGCCCACTTTT
GCTTGGGACTGCGGGCTAT -> CTTGGGACTGCGGGCTATC
CCCTTAAGCCCGCTGTGCA -> CCTTAAGCCCGCTGTGCAT
CCGAAAGTAAGTATGTATA -> CGAAAGTAAGTATGTATAT
GATCCCCTCCTGCGGAGAT -> ATCCCCTCCTGCGGAGATT
AGTTCAGGCTAGAAGTAGT -> GTTCAGGCTAGAAGTAGTA
TAGCGAAGCCCGCTTGTTG -> AGCGAAGCCCGCTTGTTGG
ACAACTGAAGGGGGCCTAT -> CAACTGAAGGGGGCCTATC
GTGCTTTGTGAGTTCTGCG -> TGCTTTGTGAGTTCTGCGC
ACTTGCGTGTCACATTCGA -> CTTGCGTGTCACATTCGAA
TCCGAACAGGAATGTCGCA -> CCGAACAGGAATGTCGCAG
CGCTGCCGAGGTCTAAGTA -> GCTGCCGAGGTCTAAGTAG
GAGGCTAGCCACTGAAAGG -> AGGCTAGCCACTGAAAGGT
GTAAGATGGTCATGGGTAA -> TAAGATGGTCATGGGTAAG
CAACCGTGCCTGTCCTATA -> AACCGTGCCTGTCCTATAC
GACGATAGTACTCGCGATT -> ACGATAGTACTCGCGATTC
TTCCCTTCAGTGGGTAAGG -> TCCCTTCAGTGGGTAAGGC
CGATTAATGGAGGAATGGC -> GATTAATGGAGGAATGGCA
CCGAACAGGAATGTCGCAG -> CGAACAGGAATGTCGCAGC
ACGCTTAGCCAGCGTCGGA -> CGCTTAGCCAGCGTCGGAC
GAGATTCCCTTCAGTGGGT -> AGATTCCCTTCAGTGGGTA
GGCCTCTCTCCGCGTGTTT -> GCCTCTCTCCGCGTGTTTG
CTGGCCTCCGAACAGGAAT -> TGGCCTCCGAACAGGAATG
CCGTCTTACAATTGGTAAT -> CGTCTTACAATTGGTAATA
TAGGGGAACCCGGTCCAAT -> AGGGGAACCCGGTCCAATA
AGAGGTATGAGCTTGCACG -> GAGGTATGAGCTTGCACGC
TGAATATAAGCCACGCGAG -> GAATATAAGCCACGCGAGC
CTTGGCTTAAACTTTGATA -> TTGGCTTAAACTTTGATAG
TAAAGTCGTTTAGTCGACT -> AAAGTCGTTTAGTCGACTG
CGAGAAACACGCGCGGTAC -> GAGAAACACGCGCGGTACC
TTACGCCAGAATTTTAATC -> TACGCCAGAATTTTAATCC
CTCCTGCGGAGATTAGGTT -> TCCTGCGGAGATTAGGTTA
GGAAGAGCAGTCGCAAGAA -> GAAGAGCAGTCGCAAGAAT
TGCGACCCATGAATATAAG -> GCGACCCATGAATATAAGC
CGTAGTGCTGATGAATAAG -> GTAGTGCTGATGAATAAGC
ATAACGCTCCACTGAACTC -> TAACGCTCCACTGAACTCT
GAACTCTTCGAAGATCGTA -> AACTCTTCGAAGATCGTAT
TGCACACCGTAGCCCACTT -> GCACACCGTAGCCCACTTT
GCCATGCGGTATCGGTACT -> CCATGCGGTATCGGTACTG
GGGCCTATCGTATCTTGGT -> GGCCTATCGTATCTTGGTA
TCCCTTTGTCGCCGTAAAC -> CCCTTTGTCGCCGTAAACT
CCCATGAATATAAGCCACG -> CCATGAATATAAGCCACGC
TCTAAGTAGTCTGGCTGGA -> CTAAGTAGTCTGGCTGGAA
AGGGCTGCCGAGGCTAGCC -> GGGCTGCCGAGGCTAGCCA
GGAAGATCTAAGACTCACT -> GAAGATCTAAGACTCACTC
CCTACAATCACAACTGAAG -> CTACAATCACAACTGAAGG
CACGCGAGCTGGGAGATTC -> ACGCGAGCTGGGAGATTCC
CCGCTGTGCATACTCAACC -> CGCTGTGCATACTCAACCA
CGGTTTACAAATCGTGAGT -> GGTTTACAAATCGTGAGTC
TAAACTTGCGTGTCACATT -> AAACTTGCGTGTCACATTC
CACAGCCACGCGAGCTGGG -> ACAGCCACGCGAGCTGGGA
CGCGCGGTTTTTTGAGCCC -> GCGCGGTTTTTTGAGCCCC
ATTGTCCTGGGAGAGGCTT -> TTGTCCTGGGAGAGGCTTA
ATAACCCCGAAGATGCGCG -> TAACCCCGAAGATGCGCGG
GCTGTAGTTCAGGCTAGAA -> CTGTAGTTCAGGCTAGAAG
TGAGGGAATCTAATATAAT -> GAGGGAATCTAATATAATT
GAGCTGGGAGCCAAATTAG -> AGCTGGGAGCCAAATTAGT
CGTGCGTCTGAAACAGGTA -> GTGCGTCTGAAACAGGTAT
AAGCTAGAGACCACTAATC -> AGCTAGAGACCACTAATCC
TCGTATTTAGTTGATTCTG -> CGTATTTAGTTGATTCTGG
GATAGCCGCTGACAGAGAA -> ATAGCCGCTGACAGAGAAA
GATTCTTACGAACACTTGT -> ATTCTTACGAACACTTGTC
AAACACCACTAGTACTCGC -> AACACCACTAGTACTCGCT
AGAGGCTTAATTTGGGATT -> GAGGCTTAATTTGGGATTA
TGTCGAGAAACACGCGCGG -> GTCGAGAAACACGCGCGGT
AAGGCCAAGGACGCAGGCA -> AGGCCAAGGACGCAGGCAT
ACCCTATTCTAAATATAGC -> CCCTATTCTAAATATAGCG
CTGGGAAGGACCCACCACA -> TGGGAAGGACCCACCACAG
AGGGGAACCCGGTCCAATA -> GGGGAACCCGGTCCAATAA
TCTCGGTTTGAACCGTGAA -> CTCGGTTTGAACCGTGAAT
TAATCCCGGTTTGAGGCCC -> AATCCCGGTTTGAGGCCCA
TTTCAGATGGCCATGCGGT -> TTCAGATGGCCATGCGGTA
CATAGCTGACGATAGTACT -> ATAGCTGACGATAGTACTC
AGAGAAATGACTAACCGTC -> GAGAAATGACTAACCGTCA
TATCCCTGCGCCTGTCGAA -> ATCCCTGCGCCTGTCGAAG
CGCCAATAAGTCTCCCGAA -> GCCAATAAGTCTCCCGAAA
CTCCCGAAAAGCCCGCGTT -> TCCCGAAAAGCCCGCGTTC
AGGACGCACCCCGTATGGC -> GGACGCACCCCGTATGGCT
TAGCGGTGGCAAATTATCC -> AGCGGTGGCAAATTATCCC
GGTAAGGCCAAGGACGCAG -> GTAAGGCCAAGGACGCAGG
TGGGGTGAGAACTTGGCTT -> GGGGTGAGAACTTGGCTTA
CCCATGCACACCGTAGCCC -> CCATGCACACCGTAGCCCA
GGTAAGGCCAAGGACGCAC -> GTAAGGCCAAGGACGCACC
CGAGCTGGGAGGTGACCGT -> GAGCTGGGAGGTGACCGTC
ATGCACACCGTAGCCCACT -> TGCACACCGTAGCCCACTT
GCCCACTTTTACAGGGGCC -> CCCACTTTTACAGGGGCCT
GCGGTGGCAAATTATCCCG -> CGGTGGCAAATTATCCCGA
GACAGGGACGCAAACGGAA -> ACAGGGACGCAAACGGAAT
TCGCCGTAGTACCAGGGCC -> CGCCGTAGTACCAGGGCCT
TGACCGAAAGTAAGTATGT -> GACCGAAAGTAAGTATGTA
ATCCCCTCCTGCGGAGATT -> TCCCCTCCTGCGGAGATTA
TTGAGGCGAGTACTTGAAT -> TGAGGCGAGTACTTGAATT
AGCGAAGCCCGCTTGTTGG -> GCGAAGCCCGCTTGTTGGC
ATGTAAAACTGCTTGAAGA -> TGTAAAACTGCTTGAAGAA
TAATGGAGGAATGGCAAAT -> AATGGAGGAATGGCAAATA
ATGTAATGAATGTAAGCGT -> TGTAATGAATGTAAGCGTC
CTGCCACTTCCAGCTGGGG -> TGCCACTTCCAGCTGGGGT
AGGTTAGCAACAACCGTGC -> GGTTAGCAACAACCGTGCC
AAGACTCACTCCATTTCAA -> AGACTCACTCCATTTCAAG
TTTAGACCACGCCCTGTTG -> TTAGACCACGCCCTGTTGA
TGTAAAACTGCTTGAAGAA -> GTAAAACTGCTTGAAGAAA
CGCTTGTTGGCCCGCCACC -> GCTTGTTGGCCCGCCACCC
GCGACAGGGACGCAAACGG -> CGACAGGGACGCAAACGGA
ACAAATAGCTGTAGTTCAG -> CAAATAGCTGTAGTTCAGG
GATAACGCTCCACTGAACT -> ATAACGCTCCACTGAACTC
TTAAAGTCGTTTAGTCGAC -> TAAAGTCGTTTAGTCGACT
TATTAAAGTCGTTTAGTCG -> ATTAAAGTCGTTTAGTCGA
ATGGCCATGCGGTATCGGT -> TGGCCATGCGGTATCGGTA
CACTAGTACTCGCTGCCGA -> ACTAGTACTCGCTGCCGAA
AGTGCTTTGTGAGTTCTGC -> GTGCTTTGTGAGTTCTGCG
TTTGATAGCCGCTGACAGA -> TTGATAGCCGCTGACAGAG
CAGTAGCGGTGGCAAATTA -> AGTAGCGGTGGCAAATTAT
AGCCCACTTTTACAGGGGC -> GCCCACTTTTACAGGGGCC
ACCGTCATTTATTTATGGA -> CCGTCATTTATTTATGGAT
GGCTGGAAATGTAATGAAT -> GCTGGAAATGTAATGAATG
ACGCGAGCTGGGAGGTGAC -> CGCGAGCTGGGAGGTGACC
TTCTCGGCGAGGGATAACG -> TCTCGGCGAGGGATAACGC
CGATCCAGGACCCTATTCT -> GATCCAGGACCCTATTCTA
TTATCCCGACACTTCCACA -> TATCCCGACACTTCCACAA
CATTTCACTTGATGTCTCA -> ATTTCACTTGATGTCTCAT
CCAATAAGTCTCCCGAAAA -> CAATAAGTCTCCCGAAAAG
AGGTATTCCGGCAGAGCCA -> GGTATTCCGGCAGAGCCAC
TAATGTCCACAACCAGGAC -> AATGTCCACAACCAGGACG
AAACGGAATTCTCGCCGTA -> AACGGAATTCTCGCCGTAG
ACCCCGAAGATGCGCGGCA -> CCCCGAAGATGCGCGGCAA
GTAAGGCCAAGGACGCAGG -> TAAGGCCAAGGACGCAGGC
TTTTTGAGCCCCTCTCAAT -> TTTTGAGCCCCTCTCAATG
TTCGTGCATGTTTAGGCGG -> TCGTGCATGTTTAGGCGGA
TAACCCCGAAGATGCGCGG -> AACCCCGAAGATGCGCGGC
TTAGTTGATTCTGGCCTCT -> TAGTTGATTCTGGCCTCTC
CAGGAGTACGGTATCCCAT -> AGGAGTACGGTATCCCATT
ATTACGCCAGAATTTTAAT -> TTACGCCAGAATTTTAATC
AACCAGGACGACCCCGCGA -> ACCAGGACGACCCCGCGAC
GCCCCCAAGTATCTGTGCT -> CCCCCAAGTATCTGTGCTG
ATCTAAGACTCACTCCATT -> TCTAAGACTCACTCCATTT
ATACCCATGCACACCGTAG -> TACCCATGCACACCGTAGC
GCTGGGGTGAGAACTTGGC -> CTGGGGTGAGAACTTGGCT
AATCTACTCTTTCAGATGG -> ATCTACTCTTTCAGATGGC
ACCGTACTCTCGGACTTTG -> CCGTACTCTCGGACTTTGA
CCGAAAAGCCCGCGTTCAG -> CGAAAAGCCCGCGTTCAGA
CTAAGTAGTCTGGCTGGAA -> TAAGTAGTCTGGCTGGAAA
CCAAGGACGCTATCCCTGC -> CAAGGACGCTATCCCTGCG
CATGGAGAAATGCCGTGTG -> ATGGAGAAATGCCGTGTGA
CCATGCGGTATCGGTACTG -> CATGCGGTATCGGTACTGG
GGCTGTAGCACGAATTTTA -> GCTGTAGCACGAATTTTAT
AAGAATCGTCACACCCCCG -> AGAATCGTCACACCCCCGT
GCTGAAGGACAGTACTTAA -> CTGAAGGACAGTACTTAAA
GGAAGGACCCACCACAGCT -> GAAGGACCCACCACAGCTT
CGAAAGTAAGTATGTATAT -> GAAAGTAAGTATGTATATC
ATGCGGTATCGGTACTGGG -> TGCGGTATCGGTACTGGGA
CTAAATATAGCGAAGCCCG -> TAAATATAGCGAAGCCCGC
ATTTCGTGCATGTTTAGGC -> TTTCGTGCATGTTTAGGCG
CACTTTTACAGGGGCCTTT -> ACTTTTACAGGGGCCTTTC
CCCCTCTCAATGCGCTAGC -> CCCTCTCAATGCGCTAGCC
CCCGACACTTCCACAAACC -> CCGACACTTCCACAAACCG
ACCCCCGTCTTACAATTGG -> CCCCCGTCTTACAATTGGT
TTTGAGCCCCTCTCAATGC -> TTGAGCCCCTCTCAATGCG
GATTATCCCAGGCCCCTTA -> ATTATCCCAGGCCCCTTAA
TCAGTACCGCTGCCGAGGT -> CAGTACCGCTGCCGAGGTC
GATGTCGAGAAACACGCGC -> ATGTCGAGAAACACGCGCG
TGGCTCAGCCCGTAACGCA -> GGCTCAGCCCGTAACGCAT
CTATCTGAAAACTAATGTC -> TATCTGAAAACTAATGTCC
AAGCCCGCGTTCAGAGATG -> AGCCCGCGTTCAGAGATGT
CGACAGGGACGCAAACGGA -> GACAGGGACGCAAACGGAA
TGGGAGAGGCTTAATTTGG -> GGGAGAGGCTTAATTTGGG
TATCTGTGCTGCGTCATAA -> ATCTGTGCTGCGTCATAAT
CCATTTCACTTGATGTCTC -> CATTTCACTTGATGTCTCA
GCGGGAGGAAATCGGGACA -> CGGGAGGAAATCGGGACAC
GACGACCCCGCGACAGGGA -> ACGACCCCGCGACAGGGAC
GGGAGAGGCTTAATTTGGG -> GGAGAGGCTTAATTTGGGA
GTACCGTACTCTCGGACTT -> TACCGTACTCTCGGACTTT
ATCTGCTCTCCCAGGAGTA -> TCTGCTCTCCCAGGAGTAC
CGGGACACAAGTGCGACCC -> GGGACACAAGTGCGACCCA
TATCGTATCTTGGTAGCCA -> ATCGTATCTTGGTAGCCAC
TATAGCGAAGCCCGCTTGT -> ATAGCGAAGCCCGCTTGTT
TGCAGTAAACACAGCCACG -> GCAGTAAACACAGCCACGC
AAGTATGTATATCATGTAA -> AGTATGTATATCATGTAAA
CTACTCTTTCAGATGGCCA -> TACTCTTTCAGATGGCCAT
AGCCACTGAAAGGTTAGCA -> GCCACTGAAAGGTTAGCAA
TATCCCGACACTTCCACAA -> ATCCCGACACTTCCACAAA
GTCGCAAGAATCGTCACAC -> TCGCAAGAATCGTCACACC
GGGAGCCAAATTAGTCTGG -> GGAGCCAAATTAGTCTGGG
CTATACCCATGCACACCGT -> TATACCCATGCACACCGTA
AAACAGGTATTCCGGCAGA -> AACAGGTATTCCGGCAGAG
CACGCGAGCTGGGAGGTGA -> ACGCGAGCTGGGAGGTGAC
ATCTAATATAATTGCCGAT -> TCTAATATAATTGCCGATT
AGATTAGGTTACACCATCT -> GATTAGGTTACACCATCTT
TACAATTGGTAATACCGCC -> ACAATTGGTAATACCGCCA
TTGGTAGCCACGCGAGCTG -> TGGTAGCCACGCGAGCTGG
CACCCCCGTCTTACAATTG -> ACCCCCGTCTTACAATTGG
TTTATGGATCTTTCTCTGG -> TTATGGATCTTTCTCTGGT
CAAATTATCCCGACACTTC -> AAATTATCCCGACACTTCC
CGGCGAGGGATAACGCTCC -> GGCGAGGGATAACGCTCCA
TCGCAAGAATCGTCACACC -> CGCAAGAATCGTCACACCC
GGACTGCGGGCTATCTGAA -> GACTGCGGGCTATCTGAAA
CAGTACGTCCCTGGCCTCC -> AGTACGTCCCTGGCCTCCG
TAAAGGGAAGATCTAAGAC -> AAAGGGAAGATCTAAGACT
TATACCCATGCACACCGTA -> ATACCCATGCACACCGTAG
GGCCAAGGACGCTATCCCT -> GCCAAGGACGCTATCCCTG
ATGCACCATTTCACTTGAT -> TGCACCATTTCACTTGATG
AACACTTGTCGGGCTGTAG -> ACACTTGTCGGGCTGTAGC
AAACTTGCGTGTCACATTC -> AACTTGCGTGTCACATTCG
CCCTTCAGTGGGTAAGGCC -> CCTTCAGTGGGTAAGGCCA
GTATTCCGGCAGAGCCACG -> TATTCCGGCAGAGCCACGC
TTTTAATCCCGGTTTGAGG -> TTTAATCCCGGTTTGAGGC
GAAGTCATACAATGATCCC -> AAGTCATACAATGATCCCC
ATTCTGCAATACGTGCGTC -> TTCTGCAATACGTGCGTCT
CGCAAGAATCGTCACACCC -> GCAAGAATCGTCACACCCC
TCAATTACGCCAGAATTTT -> CAATTACGCCAGAATTTTA
TAAGATGGTCATGGGTAAG -> AAGATGGTCATGGGTAAGG
GTAAGTGCCACTCCGGCGA -> TAAGTGCCACTCCGGCGAG
GGAGAGGTATGAGCTTGCA -> GAGAGGTATGAGCTTGCAC
CGATAGTACTCGCGATTCG -> GATAGTACTCGCGATTCGA
TGGCTTAAACTTTGATAGC -> GGCTTAAACTTTGATAGCC
ACGCAGGCATTTTAGACCA -> CGCAGGCATTTTAGACCAC
GAGATTAGGTTACACCATC -> AGATTAGGTTACACCATCT
GGCTAGCCACTGAAAGGTT -> GCTAGCCACTGAAAGGTTA
GGCCCGCCACCCCCGGTTT -> GCCCGCCACCCCCGGTTTA
CCGTCATTTATTTATGGAT -> CGTCATTTATTTATGGATC
ATTCGAGGCCGGAAGAGCA -> TTCGAGGCCGGAAGAGCAG
ATCAATTACGCCAGAATTT -> TCAATTACGCCAGAATTTT
GAATTGTTTAATCAATTAC -> AATTGTTTAATCAATTACG
ATACGTGCGTCTGAAACAG -> TACGTGCGTCTGAAACAGG
ACAGGTATTCCGGCAGAGC -> CAGGTATTCCGGCAGAGCC
AGATCGTATTTAGTTGATT -> GATCGTATTTAGTTGATTC
AATTGTCCTGGGAGAGGCT -> ATTGTCCTGGGAGAGGCTT
GTGGCATGAACATTTATAA -> TGGCATGAACATTTATAAC
TCTTAGATTTCCTATCTGC -> CTTAGATTTCCTATCTGCC
CTGAGGGAATCTAATATAA -> TGAGGGAATCTAATATAAT
GATTCAGTACCGCTGCCGA -> ATTCAGTACCGCTGCCGAG
TTTCAAGACGTAGTGCTGA -> TTCAAGACGTAGTGCTGAT
TCCCCTCCTGCGGAGATTA -> CCCCTCCTGCGGAGATTAG
ACAATCACAACTGAAGGGG -> CAATCACAACTGAAGGGGG
CTACAATCACAACTGAAGG -> TACAATCACAACTGAAGGG
TCCTGAGGGAATCTAATAT -> CCTGAGGGAATCTAATATA
ATGAATATAAGCCACGCGA -> TGAATATAAGCCACGCGAG
AGATCTAAGACTCACTCCA -> GATCTAAGACTCACTCCAT
ACTGGATCCTCTCGGTTTG -> CTGGATCCTCTCGGTTTGA
TCTGCGCTCGGATGTGTTA -> CTGCGCTCGGATGTGTTAG
ACGTACGGATCTGCTCTCC -> CGTACGGATCTGCTCTCCC
GGCCATGCGGTATCGGTAC -> GCCATGCGGTATCGGTACT
TTAGTCTGGGTAAGGCCAA -> TAGTCTGGGTAAGGCCAAG
GCCAAGGACGCTTAGCCAG -> CCAAGGACGCTTAGCCAGC
CGTCAGTGGGTAAGGCCAA -> GTCAGTGGGTAAGGCCAAG
TTTTACAGGGGCCTTTCCT -> TTTACAGGGGCCTTTCCTG
ACCTACACGTGTAGTGCTA -> CCTACACGTGTAGTGCTAG
GCCTCTCTCCGCGTGTTTG -> CCTCTCTCCGCGTGTTTGC
AGAGCCACGCGAGCTGGGA -> GAGCCACGCGAGCTGGGAG
CTCTCCGCGTGTTTGCTTA -> TCTCCGCGTGTTTGCTTAT
CGGTTTTTTGAGCCCCTCT -> GGTTTTTTGAGCCCCTCTC
AGGCGGATCGCATGTGATG -> GGCGGATCGCATGTGATGC
AGCAGTAAGTGCCACTCCG -> GCAGTAAGTGCCACTCCGG
ACTCCCTTTGTCGCCGTAA -> CTCCCTTTGTCGCCGTAAA
GACACTTCCACAAACCGAT -> ACACTTCCACAAACCGATC
CAATGATCCCCTCCTGCGG -> AATGATCCCCTCCTGCGGA
ATAGTGCTTTGTGAGTTCT -> TAGTGCTTTGTGAGTTCTG
GTGCAGTAAACACAGCCAC -> TGCAGTAAACACAGCCACG
CGCTGAAGGACAGTACTTA -> GCTGAAGGACAGTACTTAA
GAGAAATGCCGTGTGATTC -> AGAAATGCCGTGTGATTCT
GGAGTAAGATGGTCATGGG -> GAGTAAGATGGTCATGGGT
AGGCCGGAAGAGCAGTCGC -> GGCCGGAAGAGCAGTCGCA
TGGGATTATCCCAGGCCCC -> GGGATTATCCCAGGCCCCT
AACAGGTATTCCGGCAGAG -> ACAGGTATTCCGGCAGAGC
TTGGCTTAAACTTTGATAG -> TGGCTTAAACTTTGATAGC
CACCCCGTATGGCTCAGCC -> ACCCCGTATGGCTCAGCCC
TTTGAACCGTGAATCCGGC -> TTGAACCGTGAATCCGGCG
AAAGGTTAGCAACAACCGT -> AAGGTTAGCAACAACCGTG
CCCCCAAGTATCTGTGCTG -> CCCCAAGTATCTGTGCTGC
TAAACTTTGATAGCCGCTG -> AAACTTTGATAGCCGCTGA
TCCGGCGAGCCCCCAAGTA -> CCGGCGAGCCCCCAAGTAT
ATGGGTAAGGCCAAGGACG -> TGGGTAAGGCCAAGGACGC
TCCCATTGATGCACCATTT -> CCCATTGATGCACCATTTC
GTTCTGCGCTCGGATGTGT -> TTCTGCGCTCGGATGTGTT
AGCCCGCTTGTTGGCCCGC -> GCCCGCTTGTTGGCCCGCC
GATTCCCTTCAGTGGGTAA -> ATTCCCTTCAGTGGGTAAG
ACGCGAGCTGGGAGTAAGA -> CGCGAGCTGGGAGTAAGAT
GAGCTTGCACGCGCGGTTT -> AGCTTGCACGCGCGGTTTT
CTAGCCACTGAAAGGTTAG -> TAGCCACTGAAAGGTTAGC
TGTCGGGCTGTAGCACGAA -> GTCGGGCTGTAGCACGAAT
GTAACGCATGGAGAAATGC -> TAACGCATGGAGAAATGCC
AGGTGACCGTCAGTGGGTA -> GGTGACCGTCAGTGGGTAA
GTACGGCAGTACGTCCCTG -> TACGGCAGTACGTCCCTGG
CCCAGAATGAGGGCTGCCG -> CCAGAATGAGGGCTGCCGA
ATTTTATACAAGTACCGTG -> TTTTATACAAGTACCGTGG
TTCGAAGATCGTATTTAGT -> TCGAAGATCGTATTTAGTT
AAATGTAATGAATGTAAGC -> AATGTAATGAATGTAAGCG
TATGGCTCAGCCCGTAACG -> ATGGCTCAGCCCGTAACGC
CCATTTCAAGACGTAGTGC -> CATTTCAAGACGTAGTGCT
ATTCCCTTCAGTGGGTAAG -> TTCCCTTCAGTGGGTAAGG
TGGAGAGGTATGAGCTTGC -> GGAGAGGTATGAGCTTGCA
CTCGGCGAGGGATAACGCT -> TCGGCGAGGGATAACGCTC
ATGGAGGAATGGCAAATAA -> TGGAGGAATGGCAAATAAA
GCCCAGAATGAGGGCTGCC -> CCCAGAATGAGGGCTGCCG
ATATAGCGAAGCCCGCTTG -> TATAGCGAAGCCCGCTTGT
ATTTTAGACCACGCCCTGT -> TTTTAGACCACGCCCTGTT
ACACCGTAGCCCACTTTTA -> CACCGTAGCCCACTTTTAC
GCTCTCCCAGGAGTACGGT -> CTCTCCCAGGAGTACGGTA
GGGCTATCTGAAAACTAAT -> GGCTATCTGAAAACTAATG
AGATGCGCGGCAACCTACA -> GATGCGCGGCAACCTACAC
TGCGCGGCAACCTACACGT -> GCGCGGCAACCTACACGTG
GCGAGCTGGGAGTAAGATG -> CGAGCTGGGAGTAAGATGG
ACTTCCAGCTGGGGTGAGA -> CTTCCAGCTGGGGTGAGAA
CGGTCCAATAATCTACTCT -> GGTCCAATAATCTACTCTT
GTCCAATAATCTACTCTTT -> TCCAATAATCTACTCTTTC
GCAACAACCGTGCCTGTCC -> CAACAACCGTGCCTGTCCT
AGGCCAAGGACGCTTAGCC -> GGCCAAGGACGCTTAGCCA
TGTCCTATACCCATGCACA -> GTCCTATACCCATGCACAC
AGGACCCACCACAGCTTGG -> GGACCCACCACAGCTTGGG
CGTGGAGAGGTATGAGCTT -> GTGGAGAGGTATGAGCTTG
CTAATTGTCCTGGGAGAGG -> TAATTGTCCTGGGAGAGGC
TGAGCCCCTCTCAATGCGC -> GAGCCCCTCTCAATGCGCT
AATCGTCACACCCCCGTCT -> ATCGTCACACCCCCGTCTT
CAACCCCGAGGGCAGATTC -> AACCCCGAGGGCAGATTCA
CGTGTTTGCTTATGTACGG -> GTGTTTGCTTATGTACGGC
GAACAGGAATGTCGCAGCA -> AACAGGAATGTCGCAGCAG
ACAGAGAAATGACTAACCG -> CAGAGAAATGACTAACCGT
GCGAGGGATAACGCTCCAC -> CGAGGGATAACGCTCCACT
TTGATTCTGGCCTCTCTCC -> TGATTCTGGCCTCTCTCCG
AGAGACCACTAATCCGACT -> GAGACCACTAATCCGACTA
TGATCCCCTCCTGCGGAGA -> GATCCCCTCCTGCGGAGAT
GTATGTATATCATGTAAAA -> TATGTATATCATGTAAAAC
TCTCTCCGCGTGTTTGCTT -> CTCTCCGCGTGTTTGCTTA
TCCCGGTTTGAGGCCCAGA -> CCCGGTTTGAGGCCCAGAA
GGACGACCCCGCGACAGGG -> GACGACCCCGCGACAGGGA
ATGCTGGTGGCCTTGCAGT -> TGCTGGTGGCCTTGCAGTA
GAGGAAATCGGGACACAAG -> AGGAAATCGGGACACAAGT
CGCGTGTTTGCTTATGTAC -> GCGTGTTTGCTTATGTACG
AATGGTATGGGTAGGGGAA -> ATGGTATGGGTAGGGGAAC
GGAGGAATGGCAAATAAAC -> GAGGAATGGCAAATAAACA
CATTTTAGACCACGCCCTG -> ATTTTAGACCACGCCCTGT
AATACGTACGGATCTGCTC -> ATACGTACGGATCTGCTCT
CGATTCGAGGCCGGAAGAG -> GATTCGAGGCCGGAAGAGC
GCGAGCCCCCAAGTATCTG -> CGAGCCCCCAAGTATCTGT
TAGCCTGACTCCCTTTGTC -> AGCCTGACTCCCTTTGTCG
TGTAGCACGAATTTTATAC -> GTAGCACGAATTTTATACA
GCACCATTTCACTTGATGT -> CACCATTTCACTTGATGTC
ATGCGCGGCAACCTACACG -> TGCGCGGCAACCTACACGT
TATGTATATCATGTAAAAC -> ATGTATATCATGTAAAACT
TTGATAGCCGCTGACAGAG -> TGATAGCCGCTGACAGAGA
GCCAATAAGTCTCCCGAAA -> CCAATAAGTCTCCCGAAAA
ACTAATCCGACTACATAGC -> CTAATCCGACTACATAGCT
GCAGGCATTTTAGACCACG -> CAGGCATTTTAGACCACGC
GCTGCGTCATAATTTCGTG -> CTGCGTCATAATTTCGTGC
GCGTGTTTGCTTATGTACG -> CGTGTTTGCTTATGTACGG
GCTGCCGAACAACCCCGAG -> CTGCCGAACAACCCCGAGG
AGGCATTTTAGACCACGCC -> GGCATTTTAGACCACGCCC
GGTGAGAACTTGGCTTAAA -> GTGAGAACTTGGCTTAAAC
TGCAATACGTGCGTCTGAA -> GCAATACGTGCGTCTGAAA
CTAGCCTGACTCCCTTTGT -> TAGCCTGACTCCCTTTGTC
ACTCGCTGCCGAACAACCC -> CTCGCTGCCGAACAACCCC
GGCAGATTCAGTACCGCTG -> GCAGATTCAGTACCGCTGC
CTGACTCCCTTTGTCGCCG -> TGACTCCCTTTGTCGCCGT
GGACGCTATCCCTGCGCCT -> GACGCTATCCCTGCGCCTG
GGGATAACGCTCCACTGAA -> GGATAACGCTCCACTGAAC
GCTGGGAGCCAAATTAGTC -> CTGGGAGCCAAATTAGTCT
CCGAAGATGCGCGGCAACC -> CGAAGATGCGCGGCAACCT
CTATTCTAAATATAGCGAA -> TATTCTAAATATAGCGAAG
GCATGGAGAAATGCCGTGT -> CATGGAGAAATGCCGTGTG
GGAATTCTCGCCGTAGTAC -> GAATTCTCGCCGTAGTACC
ATCACAACTGAAGGGGGCC -> TCACAACTGAAGGGGGCCT
CAGCGTCGGACTTTCTCGG -> AGCGTCGGACTTTCTCGGC
AGGTCTAAGTAGTCTGGCT -> GGTCTAAGTAGTCTGGCTG
GTCATGGGTAAGGCCAAGG -> TCATGGGTAAGGCCAAGGA
TGATGCTGGTGGCCTTGCA -> GATGCTGGTGGCCTTGCAG
CGCGAGCTGGGAGCCAAAT -> GCGAGCTGGGAGCCAAATT
TAGACCACGCCCTGTTGAC -> AGACCACGCCCTGTTGACC
GGAGAGGCTTAATTTGGGA -> GAGAGGCTTAATTTGGGAT
CAAGAATCGTCACACCCCC -> AAGAATCGTCACACCCCCG
GCTAGAAGTAGTATTATTA -> CTAGAAGTAGTATTATTAA
CACTGAACTCTTCGAAGAT -> ACTGAACTCTTCGAAGATC
GGAATGTCGCAGCAGTAAG -> GAATGTCGCAGCAGTAAGT
AAGTAGTCTGGCTGGAAAT -> AGTAGTCTGGCTGGAAATG
GCAGATTCAGTACCGCTGC -> CAGATTCAGTACCGCTGCC
GCCGCTGACAGAGAAATGA -> CCGCTGACAGAGAAATGAC
CCCGCTGAAGGACAGTACT -> CCGCTGAAGGACAGTACTT
AGCCCGCGTTCAGAGATGT -> GCCCGCGTTCAGAGATGTC
GCGGTTTTTTGAGCCCCTC -> CGGTTTTTTGAGCCCCTCT
GAAAAGCCCGCGTTCAGAG -> AAAAGCCCGCGTTCAGAGA
ACTCAACCAGAGATTCTGC -> CTCAACCAGAGATTCTGCA
CACGCGAGCTGGGAGTAAG -> ACGCGAGCTGGGAGTAAGA
ATAGCTGTAGTTCAGGCTA -> TAGCTGTAGTTCAGGCTAG
AGGGGCCTTTCCTGAGGGA -> GGGGCCTTTCCTGAGGGAA
AAATGACTAACCGTCATTT -> AATGACTAACCGTCATTTA
GGCTATCTGAAAACTAATG -> GCTATCTGAAAACTAATGT
CGTGTGATTCTTACGAACA -> GTGTGATTCTTACGAACAC
CTTAAGCCCGCTGTGCATA -> TTAAGCCCGCTGTGCATAC
TGAGGCGAGTACTTGAATT -> GAGGCGAGTACTTGAATTG
CTAATCCGACTACATAGCT -> TAATCCGACTACATAGCTG
ATGTCGAGAAACACGCGCG -> TGTCGAGAAACACGCGCGG
TATGTACGGCAGTACGTCC -> ATGTACGGCAGTACGTCCC
AATGTCGCAGCAGTAAGTG -> ATGTCGCAGCAGTAAGTGC
AGAGCAGTCGCAAGAATCG -> GAGCAGTCGCAAGAATCGT
CATTCGAAGTTTCTTCATT -> ATTCGAAGTTTCTTCATTA
CCTATACCCATGCACACCG -> CTATACCCATGCACACCGT
CATGGGTAAGGCCAAGGAC -> ATGGGTAAGGCCAAGGACG
CCGTGAATCCGGCGGGAGG -> CGTGAATCCGGCGGGAGGA
ATTATCCCGACACTTCCAC -> TTATCCCGACACTTCCACA
CGAGGCTAGCCACTGAAAG -> GAGGCTAGCCACTGAAAGG
TTGGGATTATCCCAGGCCC -> TGGGATTATCCCAGGCCCC
ATCTGAAAACTAATGTCCA -> TCTGAAAACTAATGTCCAC
