TGCTCACAATA -> GCTCACAATAC
ACTTAGGCCTG -> CTTAGGCCTGA
TGGTTGCATTC -> GGTTGCATTCT
TTAGGCCTGAC -> TAGGCCTGACG
ACATAATAAAT -> CATAATAAATT
AATAAGTTACT -> ATAAGTTACTT
GACTCTAATGT -> ACTCTAATGTT
ACGCGCACATG -> CGCGCACATGG
CGTCACGATGC -> GTCACGATGCA
TAGCCTGCTTC -> AGCCTGCTTCG
TCATAAGAGAC -> CATAAGAGACT
CTCTCACGTGC -> TCTCACGTGCT
ATATGGGCGGT -> TATGGGCGGTA
GTCTAACATCC -> TCTAACATCCA
GCCAGTATCGA -> CCAGTATCGAT
ATTGCTGATAT -> TTGCTGATATG
GCGTGAGGACG -> CGTGAGGACGG
AAGAATAATGA -> AGAATAATGAC
CCTCGAGTTAC -> CTCGAGTTACA
CAGTTATATTA -> AGTTATATTAT
ACTTTCCAGAG -> CTTTCCAGAGC
CTCTCAGACCT -> TCTCAGACCTA
CTGCTTGATTA -> TGCTTGATTAG
GCCATGGTCCC -> CCATGGTCCCA
CGTGGCTCTGA -> GTGGCTCTGAC
GTATCCGGAGG -> TATCCGGAGGG
TCTAGCCATGG -> CTAGCCATGGT
TCGATTAGTTC -> CGATTAGTTCC
CTTACTGTGCA -> TTACTGTGCAG
CGACCCGCTAA -> GACCCGCTAAC
ACAAGATACTC -> CAAGATACTCA
ATCTCATAAGA -> TCTCATAAGAG
TGACCTATAGC -> GACCTATAGCC
AAAAACGGCGA -> AAAACGGCGAG
ACGGACGGTTC -> CGGACGGTTCA
AAGCTGGCGAG -> AGCTGGCGAGT
ATAGTTCGTTT -> TAGTTCGTTTT
GTTCAGATGTT -> TTCAGATGTTA
TATCCCTACCG -> ATCCCTACCGC
CTACCTAGAAC -> TACCTAGAACG
CGGGCAATAAT -> GGGCAATAATG
CCGCTGCTTGA -> CGCTGCTTGAT
GTGATCTATCT -> TGATCTATCTC
AGGTTACGGAG -> GGTTACGGAGT
GGTTGCATTCT -> GTTGCATTCTC
CCTGTCAACAC -> CTGTCAACACA
TGCTGCCCAGG -> GCTGCCCAGGC
TGCATCCAACC -> GCATCCAACCG
TTACATTCATC -> TACATTCATCG
ATAATGTAAAA -> TAATGTAAAAA
ACGTTGGGTTT -> CGTTGGGTTTA
GCGGGCAATAA -> CGGGCAATAAT
TGGGCGCAGTT -> GGGCGCAGTTA
ACATGGCCCAA -> CATGGCCCAAA
CCTTACCGACT -> CTTACCGACTG
TCAAATAAGTT -> CAAATAAGTTA
GCCCAAACTTT -> CCCAAACTTTC
CTGCATCCTTG -> TGCATCCTTGA
TGCCAAAGACC -> GCCAAAGACCC
AAGCTTACGGC -> AGCTTACGGCC
TAAGTAACTAG -> AAGTAACTAGT
CAATACCAGAG -> AATACCAGAGG
GGCAAAGGCGA -> GCAAAGGCGAG
GCTGAAGCGTG -> CTGAAGCGTGA
CTCCAGTGCTA -> TCCAGTGCTAG
TCAGACCTAAG -> CAGACCTAAGA
CATCCATTATC -> ATCCATTATCC
AAATAAGTTAC -> AATAAGTTACT
TTCGCACGAGA -> TCGCACGAGAT
GCTAGCGTTTA -> CTAGCGTTTAA
ACGGATGGTAT -> CGGATGGTATC
GGCGCACCCCA -> GCGCACCCCAT
GACGGACGGTT -> ACGGACGGTTC
TAGCCCTCCAG -> AGCCCTCCAGT
CGGCCTAGGCA -> GGCCTAGGCAC
TTGCTGATATG -> TGCTGATATGG
CCGTTCTCCCT -> CGTTCTCCCTC
CCGGACATAGC -> CGGACATAGCT
CAGAGGAGCAC -> AGAGGAGCACA
TTCTGCTTGGT -> TCTGCTTGGTG
TACTCACGGCA -> ACTCACGGCAA
TTATGCCTCGC -> TATGCCTCGCG
TATATTATAAA -> ATATTATAAAA
CCTACGCCAGT -> CTACGCCAGTT
TTGGCGCTACA -> TGGCGCTACAA
GCGGCTCTGGA -> CGGCTCTGGAC
AAGGATCCAGA -> AGGATCCAGAT
ATTTTTGTATC -> TTTTTGTATCA
CGTCGTCCTAC -> GTCGTCCTACC
AGGCCTGACGG -> GGCCTGACGGT
CGTGATCAGTC -> GTGATCAGTCT
TTTGCACTTAT -> TTGCACTTATG
ATTAGTTCCTC -> TTAGTTCCTCC
ACAAAGTCCTG -> CAAAGTCCTGC
GCGAGTATTGA -> CGAGTATTGAA
CAGCTCTTCAC -> AGCTCTTCACG
ACCAAATGTGC -> CCAAATGTGCC
TACCTCGAGTT -> ACCTCGAGTTA
GGGAGTGGTCC -> GGAGTGGTCCG
CAAGTAATGTA -> AAGTAATGTAT
CCTATAGCCTG -> CTATAGCCTGC
TTACGGAGTGT -> TACGGAGTGTA
GCGGTTCCAGC -> CGGTTCCAGCA
CTCGAGTTACA -> TCGAGTTACAT
TAATGCCAGAC -> AATGCCAGACC
ACACAAAAATG -> CACAAAAATGT
TACCATGATAG -> ACCATGATAGT
ACTACTTATAG -> CTACTTATAGG
TGCGCGCTCTT -> GCGCGCTCTTG
TGCCCGTCCTG -> GCCCGTCCTGT
TGGGCGGTATT -> GGGCGGTATTT
GAGCACATTAA -> AGCACATTAAG
TTCTAGAGCAG -> TCTAGAGCAGT
ATTTGTGCATA -> TTTGTGCATAC
GCTTACGGCCT -> CTTACGGCCTA
GCTCTTCACGC -> CTCTTCACGCC
GACTACCATGA -> ACTACCATGAT
GGCTCGGTGGC -> GCTCGGTGGCC
TTCCGTTCTGC -> TCCGTTCTGCT
GATACTCAAGA -> ATACTCAAGAA
TTGTATCAGGC -> TGTATCAGGCG
GGTCACACCTA -> GTCACACCTAT
TTACATAATGT -> TACATAATGTA
TTCCTCCTTAC -> TCCTCCTTACC
ACACGGCGGTT -> CACGGCGGTTC
CCGTTGAACCG -> CGTTGAACCGC
CATTGGCAGCG -> ATTGGCAGCGT
CTGTCTATTTT -> TGTCTATTTTC
CTTGACGTGGC -> TTGACGTGGCT
TAGTTCGTTTT -> AGTTCGTTTTG
CCGCGACCCGG -> CGCGACCCGGG
CTCTGGACGCT -> TCTGGACGCTA
CAACTACTTAT -> AACTACTTATA
GCAATGATGTA -> CAATGATGTAC
TGGCTTTAGCC -> GGCTTTAGCCG
CGCCAGTTATG -> GCCAGTTATGT
TCTTGCTATAT -> CTTGCTATATC
ACTTATGAAAG -> CTTATGAAAGT
CTTATGCCTCG -> TTATGCCTCGC
GTGCTTACAGT -> TGCTTACAGTT
CTTGACAGGGA -> TTGACAGGGAG
CTACTTATAGG -> TACTTATAGGG
CAGATAACGGT -> AGATAACGGTC
ACTGACCGTTC -> CTGACCGTTCT
GTGGCCTCTCA -> TGGCCTCTCAG
TGGTCCCAAGG -> GGTCCCAAGGA
CGCTGCTTGAT -> GCTGCTTGATT
GTGCTAGGCCG -> TGCTAGGCCGC
ATCCATATTGT -> TCCATATTGTA
AACCGCTGCTT -> ACCGCTGCTTG
TGGCGAGTGAG -> GGCGAGTGAGA
ATGGTGTTAAG -> TGGTGTTAAGC
CTGTCAACACA -> TGTCAACACAA
GATTAGTTCCT -> ATTAGTTCCTC
TATGTGCTGCC -> ATGTGCTGCCC
CGCTGTTAAAG -> GCTGTTAAAGC
TTCATGGCGCA -> TCATGGCGCAC
AGGGTGTCGAT -> GGGTGTCGATT
AGATCGTGAAC -> GATCGTGAACT
CATAATGTAAA -> ATAATGTAAAA
TAGCTACGATG -> AGCTACGATGC
CCGGAGGGGTG -> CGGAGGGGTGG
GGTATCCATAT -> GTATCCATATT
CGCACCCCATG -> GCACCCCATGG
GAAAGTCTTTC -> AAAGTCTTTCA
ATCCCTACCGC -> TCCCTACCGCT
TCCCTCGGACA -> CCCTCGGACAA
CTCACGGCAAA -> TCACGGCAAAG
CGGGAACCGCT -> GGGAACCGCTG
CACGGATGGTA -> ACGGATGGTAT
CCAACTGACCG -> CAACTGACCGT
CGTTTAAGCTT -> GTTTAAGCTTA
GCACCTGTTGC -> CACCTGTTGCG
CACCTGTTGCG -> ACCTGTTGCGC
TCAGATGTTAT -> CAGATGTTATG
CTTTAGCCGGA -> TTTAGCCGGAC
TATCACATAAT -> ATCACATAATA
GTCCTGCCCGT -> TCCTGCCCGTC
ATTAGGATTCA -> TTAGGATTCAG
ATGCCACAAGA -> TGCCACAAGAT
ACCGACTGTTG -> CCGACTGTTGC
AAGGCGAGAGG -> AGGCGAGAGGC
CAGCACTCACC -> AGCACTCACCG
GCATGGGCCGT -> CATGGGCCGTG
TAAGCACTGCC -> AAGCACTGCCA
CATACGCATGC -> ATACGCATGCC
GCGCAGTTATA -> CGCAGTTATAT
AGCAACACAAA -> GCAACACAAAA
TTAGGATTCAG -> TAGGATTCAGG
CAGATAGGTTA -> AGATAGGTTAC
GTCCCAAGGAT -> TCCCAAGGATC
GGGCGCAGTTA -> GGCGCAGTTAT
GCGCTACAACA -> CGCTACAACAA
TTAAGCTGGCG -> TAAGCTGGCGA
GCTTTAGCCGG -> CTTTAGCCGGA
AAGACCCCGAC -> AGACCCCGACT
TTGTTTCACAC -> TGTTTCACACG
CGCATGCCAAA -> GCATGCCAAAG
CTGCTTCGGTA -> TGCTTCGGTAA
CCACGGATGGT -> CACGGATGGTA
GAGACTCTAAT -> AGACTCTAATG
CAGTGCTAGGC -> AGTGCTAGGCC
CCGGGAACCGC -> CGGGAACCGCT
GGGTTGAGATC -> GGTTGAGATCT
AGCATATATTG -> GCATATATTGT
ACTGCCACTTC -> CTGCCACTTCT
AACGCGCACAT -> ACGCGCACATG
TAAGTTACTTT -> AAGTTACTTTT
ATCTTGACGTG -> TCTTGACGTGG
GGTGATGCATA -> GTGATGCATAT
GTGCATACCCG -> TGCATACCCGC
CTCACGTGCTG -> TCACGTGCTGC
GTACCTTTACG -> TACCTTTACGT
TACGGCAGTGG -> ACGGCAGTGGT
TTCATCGAGCC -> TCATCGAGCCC
CTCTTGCTATA -> TCTTGCTATAT
AGTGGCCAGCA -> GTGGCCAGCAC
TCATCATAGAT -> CATCATAGATT
TGGCCCAAACT -> GGCCCAAACTT
AAGTAACTAGT -> AGTAACTAGTC
CGTGAGGACGG -> GTGAGGACGGA
CCTCCAGTGCT -> CTCCAGTGCTA
AAGATACTCAA -> AGATACTCAAG
ACGCGGGTCAC -> CGCGGGTCACG
GTGCAGTCACC -> TGCAGTCACCT
CACCTATGGTA -> ACCTATGGTAC
ACTGCATCCTT -> CTGCATCCTTG
CGGGTCACGTG -> GGGTCACGTGA
CGGGGCGTGCT -> GGGGCGTGCTG
GGCCGTGACGA -> GCCGTGACGAG
CAAGAATAATG -> AAGAATAATGA
GTCGTGTATAT -> TCGTGTATATG
CATGGCCCAAA -> ATGGCCCAAAC
TCCAACTACTT -> CCAACTACTTA
CCGTCCTGTCA -> CGTCCTGTCAA
GGCTCTGGACG -> GCTCTGGACGC
TTCATCACATA -> TCATCACATAC
CCGTCCTGTCT -> CGTCCTGTCTA
TGCATTCTCTT -> GCATTCTCTTC
GCGCGCTCTTG -> CGCGCTCTTGC
CATTGCTGATA -> ATTGCTGATAT
GCTGCTTGATT -> CTGCTTGATTA
GACCGCAATGA -> ACCGCAATGAT
AAGACTTGACT -> AGACTTGACTT
ACTTATAGGGT -> CTTATAGGGTG
TTCAGATGTTA -> TCAGATGTTAT
GGGTGCGCGCT -> GGTGCGCGCTC
AAGACTTGACA -> AGACTTGACAG
ATGCCTCGCGT -> TGCCTCGCGTC
TGATAGTAGAG -> GATAGTAGAGC
CGCTCTTGCTA -> GCTCTTGCTAT
CGCGACCCGGG -> GCGACCCGGGA
CATACCCGCCT -> ATACCCGCCTA
TAGAACGTTGG -> AGAACGTTGGG
CATACCTACCT -> ATACCTACCTA
CTTGATTAGGA -> TTGATTAGGAT
AAGCGTGAGGA -> AGCGTGAGGAC
CGATGCCACAA -> GATGCCACAAG
GCTCCAACTGA -> CTCCAACTGAC
AGGATTCAGGA -> GGATTCAGGAG
GATCCAGATAA -> ATCCAGATAAC
TATGGGCGGTA -> ATGGGCGGTAT
CAATAATGCCA -> AATAATGCCAG
CCTGTCTATTT -> CTGTCTATTTT
GCATTCTCTTC -> CATTCTCTTCC
GGTAAAATGAA -> GTAAAATGAAG
CTACCAGCTTG -> TACCAGCTTGC
CCTACGGCAGT -> CTACGGCAGTG
CTTCCGTTCTG -> TTCCGTTCTGC
TATGGCGCAAC -> ATGGCGCAACG
CTTGCGTCACG -> TTGCGTCACGA
AATGGCCGTGA -> ATGGCCGTGAC
GGAGTGTATGT -> GAGTGTATGTG
GATCCGCCCAC -> ATCCGCCCACT
GGGTTCCTTAT -> GGTTCCTTATC
TATTTTCATCA -> ATTTTCATCAC
CTTGGTATGGG -> TTGGTATGGGA
GCTAACCCAAG -> CTAACCCAAGT
CGTGGCTTTAG -> GTGGCTTTAGC
CCGTCAGTGGC -> CGTCAGTGGCC
TGCTGAGTAGC -> GCTGAGTAGCA
GCCTGACGGTC -> CCTGACGGTCA
CACGGCAAAGG -> ACGGCAAAGGC
ATTATAAAACT -> TTATAAAACTC
CTAGCCCTCCA -> TAGCCCTCCAG
TTGGTATGGGA -> TGGTATGGGAT
ATTTGTTTCAC -> TTTGTTTCACA
CCCTCGGACAA -> CCTCGGACAAC
GTATGGGATTT -> TATGGGATTTT
GAGGCTCGGTG -> AGGCTCGGTGG
AACTTATAAAT -> ACTTATAAATG
GTACGGGGCGT -> TACGGGGCGTG
GTAACTAGTCT -> TAACTAGTCTT
TCATCGAGCCC -> CATCGAGCCCG
GTTCCAGCATG -> TTCCAGCATGG
TGTATTGCGGG -> GTATTGCGGGC
TACCTAGAACG -> ACCTAGAACGT
CGCCCACTTAT -> GCCCACTTATG
TCATGGCGCAC -> CATGGCGCACC
TATTGCGGGCA -> ATTGCGGGCAA
TATAGCCTGCT -> ATAGCCTGCTT
TTGAGATCTAG -> TGAGATCTAGC
GGATCCAGATA -> GATCCAGATAA
AAATGCGAGTA -> AATGCGAGTAT
CTTACGGCCTA -> TTACGGCCTAG
ATAAATGGCCG -> TAAATGGCCGT
AAAAATGTGGT -> AAAATGTGGTT
CCTGCCTAATC -> CTGCCTAATCA
GGAGTGGTCCG -> GAGTGGTCCGG
TGGGCCGTGCT -> GGGCCGTGCTT
AGACTTGACTT -> GACTTGACTTA
ACAAGTTACCT -> CAAGTTACCTC
CCGCTAACCCA -> CGCTAACCCAA
GTCGTCCTACC -> TCGTCCTACCA
GCAACGCGTCG -> CAACGCGTCGG
ACAACCAAACC -> CAACCAAACCT
TATATCCCTAC -> ATATCCCTACC
AACGTTGGGTT -> ACGTTGGGTTT
CTTGACTTAGG -> TTGACTTAGGC
AGTCTTTCATT -> GTCTTTCATTG
ACAACAAGGGC -> CAACAAGGGCG
CCATGGCAAAT -> CATGGCAAATG
AGTTCCCTAAG -> GTTCCCTAAGG
TTTCACACGGC -> TTCACACGGCG
CGGCAGTGGTT -> GGCAGTGGTTG
TACCAGCTTGC -> ACCAGCTTGCA
GAGCCACCACG -> AGCCACCACGG
TGTGTGTAAGT -> GTGTGTAAGTC
CCTATCTTGAC -> CTATCTTGACG
CGCGTCCAACT -> GCGTCCAACTA
GGTTATTAGCA -> GTTATTAGCAC
GCGACCCGCTA -> CGACCCGCTAA
TCTGTCTGAGT -> CTGTCTGAGTT
TTTTGTATCAG -> TTTGTATCAGG
TGGCGCTACAA -> GGCGCTACAAC
GATTTTCACGT -> ATTTTCACGTG
GACTTGGTATG -> ACTTGGTATGG
CTCTAATGTTA -> TCTAATGTTAT
GTTCCCTAAGG -> TTCCCTAAGGC
CGGTTCCAGCA -> GGTTCCAGCAT
CCCTCCATTCT -> CCTCCATTCTG
AGCTTGCAGAT -> GCTTGCAGATT
TGCGGGCAATA -> GCGGGCAATAA
CGCTGAAGCGT -> GCTGAAGCGTG
AGTGTATGTGC -> GTGTATGTGCT
AAGGGCGCCTT -> AGGGCGCCTTA
TTTACGTTGAA -> TTACGTTGAAG
CTCATCATAGA -> TCATCATAGAT
GACCCGGGATA -> ACCCGGGATAA
CACTCATCATA -> ACTCATCATAG
AACTGACCGTT -> ACTGACCGTTC
TTCCAGCATGG -> TCCAGCATGGG
CTTGCTATATC -> TTGCTATATCC
ATGTCTGCGAC -> TGTCTGCGACC
TTATGGCGCAA -> TATGGCGCAAC
GCCGCTGTTAA -> CCGCTGTTAAA
CTCAAGAATAA -> TCAAGAATAAT
TTTTCACGTGA -> TTTCACGTGAT
ACCTACCTAGA -> CCTACCTAGAA
TGGTCCGGGAA -> GGTCCGGGAAC
GCGCCATTTGT -> CGCCATTTGTG
TAATGACCTAT -> AATGACCTATA
GTGCTGAGTAG -> TGCTGAGTAGC
GTATTGAATGC -> TATTGAATGCT
CTGTGCAGTCA -> TGTGCAGTCAC
ACTTCTAGCCA -> CTTCTAGCCAT
AAGAGACTCTA -> AGAGACTCTAA
GGCGGTTCCAG -> GCGGTTCCAGC
TACACTACGCA -> ACACTACGCAA
ATGGCCCAAAC -> TGGCCCAAACT
ATAAGTTACTT -> TAAGTTACTTT
TTGTCCTTCTA -> TGTCCTTCTAG
TCGAGCCCGAG -> CGAGCCCGAGT
TAAAGACTTGA -> AAAGACTTGAC
GACCAAATGTG -> ACCAAATGTGC
GTTAAAGCATA -> TTAAAGCATAC
GCACATTAAGC -> CACATTAAGCA
AGCTAGCGTTT -> GCTAGCGTTTA
GCAGGCACTCA -> CAGGCACTCAT
AGCCACCACGG -> GCCACCACGGT
GATAACGGTCA -> ATAACGGTCAG
GCCAGTTATGT -> CCAGTTATGTA
GAAGCTTACGG -> AAGCTTACGGC
GCCGTTGAACC -> CCGTTGAACCG
TATTGTCCTTC -> ATTGTCCTTCT
CACACGGCGGT -> ACACGGCGGTT
GCTGCGCTGAA -> CTGCGCTGAAG
CAGCCAGAGGA -> AGCCAGAGGAA
AATGTGCCCAG -> ATGTGCCCAGA
GACTTGCGTCA -> ACTTGCGTCAC
TCCAACTGACC -> CCAACTGACCG
GTCTCATTGGC -> TCTCATTGGCA
ATGCTCACAAT -> TGCTCACAATA
GTTGCGCCATT -> TTGCGCCATTT
CGCCTTACTGT -> GCCTTACTGTG
ACTTCTAGGTG -> CTTCTAGGTGA
TGATGTACTTC -> GATGTACTTCT
TGCGTCACGAT -> GCGTCACGATG
GAGTTCCCTAA -> AGTTCCCTAAG
ATGATAGTAGA -> TGATAGTAGAG
CTTTACGTCGT -> TTTACGTCGTC
TTCACACGGCG -> TCACACGGCGG
TGGACGCTACT -> GGACGCTACTC
TGGTATGGGAT -> GGTATGGGATT
CCAGCACTCAC -> CAGCACTCACC
TGCAGATTTGT -> GCAGATTTGTT
TGTGCATACCC -> GTGCATACCCG
CGTTTTGTGTG -> GTTTTGTGTGT
CCCGAGTCTCA -> CCGAGTCTCAT
GGTCCCAAGGA -> GTCCCAAGGAT
GTGTAAGTCTA -> TGTAAGTCTAC
CTACAACAAGG -> TACAACAAGGG
TGCCACAAGAT -> GCCACAAGATA
AGCTGGCGAGT -> GCTGGCGAGTG
CCTAGAACGTT -> CTAGAACGTTG
TCTTTCATTGC -> CTTTCATTGCT
GTATATGTCTA -> TATATGTCTAA
TCTCATAAGAG -> CTCATAAGAGA
GCTACAACAAG -> CTACAACAAGG
ACCTACGCCAG -> CCTACGCCAGT
ATTCGTGGCTC -> TTCGTGGCTCT
GCCCGTCCTGT -> CCCGTCCTGTC
GCCTATCTTGA -> CCTATCTTGAC
TGGGTGATTTG -> GGGTGATTTGC
TCTGACTTGGT -> CTGACTTGGTA
CATTTGTGCAT -> ATTTGTGCATA
ACAAAAATGTG -> CAAAAATGTGG
ATCCGCCCACT -> TCCGCCCACTT
TTGCATTCTCT -> TGCATTCTCTT
CTATAGCCTGC -> TATAGCCTGCT
GCACGAGATCG -> CACGAGATCGT
GCTGAGTAGCA -> CTGAGTAGCAA
GCGACCCGGGA -> CGACCCGGGAT
AGTAACTAGTC -> GTAACTAGTCT
ACACAAAGTCC -> CACAAAGTCCT
GCCGTGACGAG -> CCGTGACGAGG
GTATCGATCAA -> TATCGATCAAA
AGCACTTACGG -> GCACTTACGGA
GAGATCTAGCC -> AGATCTAGCCC
TAACATCCATT -> AACATCCATTA
ACTTATGCCTC -> CTTATGCCTCG
GTTGGGTTTAC -> TTGGGTTTACG
GTCCTACCAGC -> TCCTACCAGCT
CACCACGGATG -> ACCACGGATGG
AAATGGCCGTG -> AATGGCCGTGA
ATCCATTATCC -> TCCATTATCCC
CGGGTTGAGAT -> GGGTTGAGATC
GCCCAGAATCA -> CCCAGAATCAC
CACAAAGTCCT -> ACAAAGTCCTG
ACGTCGTCCTA -> CGTCGTCCTAC
TCAGTCTGCAT -> CAGTCTGCATC
TATTGAATGCT -> ATTGAATGCTT
AATAATGCCAG -> ATAATGCCAGA
GTTACCTCGAG -> TTACCTCGAGT
CAACACAAAGT -> AACACAAAGTC
GCGTGCTGAGT -> CGTGCTGAGTA
TCTCACGTGCT -> CTCACGTGCTG
GCAAATGCGAG -> CAAATGCGAGT
TAAGCTTACAT -> AAGCTTACATG
TTTAGCCGGAC -> TTAGCCGGACA
TTTCATGGCGC -> TTCATGGCGCA
GGCTCTGACTA -> GCTCTGACTAC
GGGCGCCTTAC -> GGCGCCTTACT
TATCTTGACGT -> ATCTTGACGTG
GTTTACGTTTG -> TTTACGTTTGG
TCCTTATCTTT -> CCTTATCTTTC
CATCAATTGCG -> ATCAATTGCGG
TGAGAACAGCT -> GAGAACAGCTC
AAATTTCAGCA -> AATTTCAGCAC
GGGATAATTTG -> GGATAATTTGC
ACCCCCTCCAT -> CCCCCTCCATT
TCTGGACGCTA -> CTGGACGCTAC
TCTTATATCAC -> CTTATATCACA
CATGATAGTAG -> ATGATAGTAGA
AAGTTACCTCG -> AGTTACCTCGA
ACGATGCAGGC -> CGATGCAGGCA
ACTCACGGCAA -> CTCACGGCAAA
TATTAGCACCT -> ATTAGCACCTG
TGACCGTTCTC -> GACCGTTCTCC
CTAAGGCTTGC -> TAAGGCTTGCA
ATGAAAGTCTT -> TGAAAGTCTTT
ACTTGACAGGG -> CTTGACAGGGA
CTGAGTAGCAA -> TGAGTAGCAAC
CCGACCAAATG -> CGACCAAATGT
ATTTGCACTAA -> TTTGCACTAAA
GTTACACTACG -> TTACACTACGC
CTTAGGCCTGA -> TTAGGCCTGAC
AAACGGCGAGC -> AACGGCGAGCC
ATCACATAATA -> TCACATAATAA
GTATCAGGCGC -> TATCAGGCGCC
GCGCACCCCAT -> CGCACCCCATG
CGTTCTCCCTC -> GTTCTCCCTCG
TAAGAGACTCT -> AAGAGACTCTA
CTTACATAATG -> TTACATAATGT
TCACATACGCA -> CACATACGCAT
CAGCAGAAGCA -> AGCAGAAGCAT
TTATCCCGTCA -> TATCCCGTCAG
TATCCCGTCAG -> ATCCCGTCAGT
CACGGTTACAC -> ACGGTTACACT
TCGTCCTACCA -> CGTCCTACCAG
GTAAAATGAAG -> TAAAATGAAGC
GAGGGGGGTTT -> AGGGGGGTTTA
AGGGAGTGGTC -> GGGAGTGGTCC
AGATACTCAAG -> GATACTCAAGA
TGATTCGTGGC -> GATTCGTGGCT
CAGCGTACGGG -> AGCGTACGGGG
GTGATTTGCAC -> TGATTTGCACT
AACAAGGGCGC -> ACAAGGGCGCC
TGCGAGTATTG -> GCGAGTATTGA
TTTACGTCGTC -> TTACGTCGTCC
TCACCTGCCTA -> CACCTGCCTAA
TTGATCCGCCC -> TGATCCGCCCA
ATAAATTTCAG -> TAAATTTCAGC
TGATAAAGACC -> GATAAAGACCG
ATGTATTGCGG -> TGTATTGCGGG
TTGGGTTTACG -> TGGGTTTACGT
ACGCTACTCAC -> CGCTACTCACG
ATGTAAAAACG -> TGTAAAAACGG
ATAAAACTCTC -> TAAAACTCTCA
ACGAGGCTCGG -> CGAGGCTCGGT
CGAGTTACATT -> GAGTTACATTC
CGATTAGTTCC -> GATTAGTTCCT
CTGTCTGAGTT -> TGTCTGAGTTC
CCTACCTAGAA -> CTACCTAGAAC
ACCCCGACTTG -> CCCCGACTTGC
CTAGGCACAGC -> TAGGCACAGCA
CCACAAGATAC -> CACAAGATACT
AGATCTAGCCC -> GATCTAGCCCT
AATAATGACCT -> ATAATGACCTA
GTTCTCCCTCG -> TTCTCCCTCGG
TTGACGTGGCT -> TGACGTGGCTT
TTAGCCGGACA -> TAGCCGGACAT
CTGACTACCAT -> TGACTACCATG
TGACTTAGGCC -> GACTTAGGCCT
GCGGTATTTTT -> CGGTATTTTTG
ATGTCTAAGTA -> TGTCTAAGTAA
AATGCTTACAT -> ATGCTTACATA
GAGGACGGACG -> AGGACGGACGG
CCGTTCTGCTT -> CGTTCTGCTTG
CTTACGGATGG -> TTACGGATGGT
GCACTGCCACT -> CACTGCCACTT
AAAGACTTGAC -> AAGACTTGACT
TTACAGTTGGC -> TACAGTTGGCG
AGGCACTCATC -> GGCACTCATCA
GCGTTTAAGCT -> CGTTTAAGCTT
AACCAAACCTA -> ACCAAACCTAC
CAAATGTGCCC -> AAATGTGCCCA
CCCGGGATAAT -> CCGGGATAATT
CAGGCGCCAGT -> AGGCGCCAGTA
TGTAAGTCTAC -> GTAAGTCTACA
CATGGCAAATG -> ATGGCAAATGC
ACGCCTATCTT -> CGCCTATCTTG
AGGCACAGCAG -> GGCACAGCAGA
CGGTTACACTA -> GGTTACACTAC
TATCTTTCATG -> ATCTTTCATGG
GATGGTATCCA -> ATGGTATCCAT
GTAAATGGGCC -> TAAATGGGCCG
CTACGCAACGC -> TACGCAACGCG
GGGTGTCGATT -> GGTGTCGATTA
ATTCTGACTTG -> TTCTGACTTGG
ATTCAGGAGGG -> TTCAGGAGGGT
ATACCTACCTA -> TACCTACCTAG
TGTACAGCCAG -> GTACAGCCAGA
GAACAGCTCTT -> AACAGCTCTTC
GCCCGAGTCTC -> CCCGAGTCTCA
AAACCTACGCC -> AACCTACGCCA
TGGCGCAACGC -> GGCGCAACGCG
TCCGTTCTGCT -> CCGTTCTGCTT
CGCCTACGGCA -> GCCTACGGCAG
TATGGTACCTT -> ATGGTACCTTT
TCTATTTTCAT -> CTATTTTCATC
CGTCCTACCAG -> GTCCTACCAGC
GGCGCTACAAC -> GCGCTACAACA
GGGCCGTGCTT -> GGCCGTGCTTA
TTACGTTGAAG -> TACGTTGAAGG
CGGACAACCAA -> GGACAACCAAA
AAGTCTACACC -> AGTCTACACCG
GGTGTCGATTA -> GTGTCGATTAG
CCCCTCCATTC -> CCCTCCATTCT
TACGTCGTCCT -> ACGTCGTCCTA
CAAGGATCCAG -> AAGGATCCAGA
CAACGCGTCGG -> AACGCGTCGGG
TGTTAAAGCAT -> GTTAAAGCATA
AGGAGCTAGCG -> GGAGCTAGCGT
CGCACGAGATC -> GCACGAGATCG
TGATATGGGCG -> GATATGGGCGG
GGCAGCGTACG -> GCAGCGTACGG
AAAGTCTTTCA -> AAGTCTTTCAT
CAGCACTTACG -> AGCACTTACGG
CCAAGGATCCA -> CAAGGATCCAG
GCCCACTTATG -> CCCACTTATGA
GACCCGCTAAC -> ACCCGCTAACC
GCTTACATGTC -> CTTACATGTCT
ACGGCGGTTCC -> CGGCGGTTCCA
CTGACCGTTCT -> TGACCGTTCTC
AGATAGGTTAC -> GATAGGTTACG
TTACGTTTGGT -> TACGTTTGGTG
ACCCGCCTACG -> CCCGCCTACGG
ATCACATACGC -> TCACATACGCA
AGTGGTTGCAT -> GTGGTTGCATT
CCAGATAACGG -> CAGATAACGGT
CTGCCCGTCCT -> TGCCCGTCCTG
GTCCGGGAACC -> TCCGGGAACCG
GTAAAAACGGC -> TAAAAACGGCG
GGAGTCTAACA -> GAGTCTAACAT
ATGTGGTTATT -> TGTGGTTATTA
CCGTGACGAGG -> CGTGACGAGGC
GCAGTACCCGG -> CAGTACCCGGT
GCTTGCAGATT -> CTTGCAGATTT
AGAACGTTGGG -> GAACGTTGGGT
ATAGTAGAGCC -> TAGTAGAGCCA
TAGGATTCAGG -> AGGATTCAGGA
GGCTTTAGCCG -> GCTTTAGCCGG
CACCTGCCTAA -> ACCTGCCTAAT
ATACATCAATT -> TACATCAATTG
TGTGCTGCCCA -> GTGCTGCCCAG
CTAGAACGTTG -> TAGAACGTTGG
GTCCTGTCTAT -> TCCTGTCTATT
GCCGGACATAG -> CCGGACATAGC
GAGTCTAACAT -> AGTCTAACATC
TGTTTCACACG -> GTTTCACACGG
CAGAGCACAAG -> AGAGCACAAGT
TAATGTAAAAA -> AATGTAAAAAC
TTACGTCGTCC -> TACGTCGTCCT
GTCTATTTTCA -> TCTATTTTCAT
TCTAAGTAACT -> CTAAGTAACTA
CTTTCATGGCG -> TTTCATGGCGC
AATAAATTTCA -> ATAAATTTCAG
ATGGTATCCAT -> TGGTATCCATA
AGTTACCTCGA -> GTTACCTCGAG
AGATAACGGTC -> GATAACGGTCA
ATGCATATCTA -> TGCATATCTAC
GTTTACGTTGA -> TTTACGTTGAA
TCTATCTCATA -> CTATCTCATAA
GCTTACAGTTG -> CTTACAGTTGG
CGCGGGTCACG -> GCGGGTCACGT
GATTCAGGAGG -> ATTCAGGAGGG
AGCGTGAGGAC -> GCGTGAGGACG
GCATCCAACCG -> CATCCAACCGA
TACTTATAGGG -> ACTTATAGGGT
AGACCCCGACT -> GACCCCGACTT
TGGGTTCCTTA -> GGGTTCCTTAT
GGCGGCGACTG -> GCGGCGACTGG
ACCGCTGCTTG -> CCGCTGCTTGA
ATCGAGCCCGA -> TCGAGCCCGAG
TGCGCCATTTG -> GCGCCATTTGT
AGTCCTGCCCG -> GTCCTGCCCGT
CGAGTCTCATT -> GAGTCTCATTG
ACGCATGCCAA -> CGCATGCCAAA
TAGCAACACAA -> AGCAACACAAA
GGTGGCCTCTC -> GTGGCCTCTCA
GCTGGCGAGTG -> CTGGCGAGTGA
GCCACTTCTAG -> CCACTTCTAGC
TTGCGTCACGA -> TGCGTCACGAT
CCAGAATCACT -> CAGAATCACTG
CCCTCCAGTGC -> CCTCCAGTGCT
TCGAGTTACAT -> CGAGTTACATT
TTTTTGTATCA -> TTTTGTATCAG
TGTCAACACAA -> GTCAACACAAA
ACTCACCGGTA -> CTCACCGGTAC
GGAGCTAGCGT -> GAGCTAGCGTT
CTTTTATGAAA -> TTTTATGAAAA
GATCAGTCTGC -> ATCAGTCTGCA
GAACGTTGGGT -> AACGTTGGGTT
CTCGGACAACC -> TCGGACAACCA
GGTGGAGTCTA -> GTGGAGTCTAA
CTGATATGGGC -> TGATATGGGCG
GATCGTGAACT -> ATCGTGAACTT
GGTCACGTGAT -> GTCACGTGATC
CCATGGTCCCA -> CATGGTCCCAA
TGTACTTCTAG -> GTACTTCTAGG
ACCCGGGATAA -> CCCGGGATAAT
ATATCTACTGC -> TATCTACTGCA
AGCGTACGGGG -> GCGTACGGGGC
TTTGCACTAAA -> TTGCACTAAAG
TCGCACGAGAT -> CGCACGAGATC
TCGGACAACCA -> CGGACAACCAA
TCCAGCATGGG -> CCAGCATGGGC
GAGCCCATATC -> AGCCCATATCG
CCCAGAATCAC -> CCAGAATCACT
TCTAGGTGAGG -> CTAGGTGAGGG
TGATGCATATC -> GATGCATATCT
CACATTAAGCA -> ACATTAAGCAC
ACTTATAAATG -> CTTATAAATGG
ACGATGCCACA -> CGATGCCACAA
GATAAAGACCG -> ATAAAGACCGC
GATCGCATGGC -> ATCGCATGGCT
AACACAAAGTC -> ACACAAAGTCC
AGCACAAGTTA -> GCACAAGTTAC
CGTGCTTACAG -> GTGCTTACAGT
ATGATGTACTT -> TGATGTACTTC
GACCCCGACTT -> ACCCCGACTTG
GTTAAGCTGGC -> TTAAGCTGGCG
GAGGAGCACAT -> AGGAGCACATT
TAAGACTTGAC -> AAGACTTGACA
CTCATAAGAGA -> TCATAAGAGAC
TGAGTTCCCTA -> GAGTTCCCTAA
ACACCGCGACC -> CACCGCGACCC
GGGTGGAGTCT -> GGTGGAGTCTA
GGCGTGCTGAG -> GCGTGCTGAGT
GAGTATTGAAT -> AGTATTGAATG
CGTTGAACCGC -> GTTGAACCGCA
TGACGTGGCTT -> GACGTGGCTTT
ATATTGTCCTT -> TATTGTCCTTC
GGACATAGCTA -> GACATAGCTAC
AGCAGTACCCG -> GCAGTACCCGG
CACACCTATGG -> ACACCTATGGT
ATACGCATGCC -> TACGCATGCCA
GAACCGCTGCT -> AACCGCTGCTT
TGCCCAGGCCG -> GCCCAGGCCGT
GTTGCATTCTC -> TTGCATTCTCT
TGGGTTTACGT -> GGGTTTACGTT
TCTTGACGTGG -> CTTGACGTGGC
GCACAGATAGG -> CACAGATAGGT
TGGCCAGCACT -> GGCCAGCACTC
CGACTTGCGTC -> GACTTGCGTCA
CCGCTGGGTTC -> CGCTGGGTTCC
CTTCACGCCTA -> TTCACGCCTAT
AAGCATATATT -> AGCATATATTG
TGTCTAAGTAA -> GTCTAAGTAAC
TTAAGCTTACA -> TAAGCTTACAT
CGAGCCCATAT -> GAGCCCATATC
GCATGCCAAAG -> CATGCCAAAGA
TTATGAAAATT -> TATGAAAATTA
TACGGGGCGTG -> ACGGGGCGTGC
TTGGTGTACAG -> TGGTGTACAGC
CAGATTTGTTT -> AGATTTGTTTC
GCTGTTAAAGC -> CTGTTAAAGCA
CACGCCTATCT -> ACGCCTATCTT
CACCGCGACCC -> ACCGCGACCCG
GTCTTCGCACG -> TCTTCGCACGA
CACATACGCAT -> ACATACGCATG
GGTTACGGAGT -> GTTACGGAGTG
GGCGCAGTTAT -> GCGCAGTTATA
TGTAAAAACGG -> GTAAAAACGGC
TGATTTGCACT -> GATTTGCACTA
CCTAAGGCTTG -> CTAAGGCTTGC
TATCGGCGGCG -> ATCGGCGGCGA
ACGGTTCAGAT -> CGGTTCAGATG
AGCACATTAAG -> GCACATTAAGC
GCTCGGTGGCC -> CTCGGTGGCCT
CTGTTGCTGCT -> TGTTGCTGCTC
ACTAGTCTTCG -> CTAGTCTTCGC
GGCAAATGCGA -> GCAAATGCGAG
GAAGGGATTGG -> AAGGGATTGGG
CCTAAGACTTG -> CTAAGACTTGA
TTTGTTTCACA -> TTGTTTCACAC
AGGCCGCTGTT -> GGCCGCTGTTA
AGAATAATGAC -> GAATAATGACC
CACCGGTACAC -> ACCGGTACACC
TAAGCTGGCGA -> AAGCTGGCGAG
TTTCCAGAGCA -> TTCCAGAGCAC
GCACTTACGGA -> CACTTACGGAT
AATGGGCCGTT -> ATGGGCCGTTG
CTCTGTCTGAG -> TCTGTCTGAGT
CTATGGTACCT -> TATGGTACCTT
TTGGCAGCGTA -> TGGCAGCGTAC
TGGGATTTTCA -> GGGATTTTCAC
GGGATTTTCAC -> GGATTTTCACG
TGGCCTCTCAG -> GGCCTCTCAGA
CTGGGCGCAGT -> TGGGCGCAGTT
ACGTGATCAGT -> CGTGATCAGTC
AACTAGTCTTC -> ACTAGTCTTCG
GTGATCGCATG -> TGATCGCATGG
GCGCTGAAGCG -> CGCTGAAGCGT
CGGATGGTGTT -> GGATGGTGTTA
CGGTCGTGTAT -> GGTCGTGTATA
ATGTTATGCTC -> TGTTATGCTCA
AATCACTGGCG -> ATCACTGGCGA
AGCACTCACCG -> GCACTCACCGG
AGGAATCTTAT -> GGAATCTTATA
CGGAGTGTATG -> GGAGTGTATGT
ATAATAAATTT -> TAATAAATTTC
CCGGTCGTGTA -> CGGTCGTGTAT
TTCGGTAAAAT -> TCGGTAAAATG
TATAGGGTGCG -> ATAGGGTGCGC
CCATTCTGACT -> CATTCTGACTT
CAATTGCGGCT -> AATTGCGGCTC
CGTGAACTTAT -> GTGAACTTATA
GTTACTTTTAT -> TTACTTTTATG
ACTTGGTATGG -> CTTGGTATGGG
ACGGCCTAGGC -> CGGCCTAGGCA
ATCACTGGCGA -> TCACTGGCGAT
TCCAGATAACG -> CCAGATAACGG
CGGTACACCGA -> GGTACACCGAC
AAATGTGCCCA -> AATGTGCCCAG
AGCAGAAGCAT -> GCAGAAGCATA
GTGGCCAGCAC -> TGGCCAGCACT
GTGCGCGCTCT -> TGCGCGCTCTT
CAGCATGGGCC -> AGCATGGGCCG
TAGGCACAGCA -> AGGCACAGCAG
CGTCCAACTAC -> GTCCAACTACT
ACTGGCGATCT -> CTGGCGATCTT
GTGATCAGTCT -> TGATCAGTCTG
AGACTTGACAG -> GACTTGACAGG
TCGTTTTGTGT -> CGTTTTGTGTG
GGTCAGTGATC -> GTCAGTGATCG
ATCCTTGATTC -> TCCTTGATTCG
GCTCTGGACGC -> CTCTGGACGCT
GAATATAGTTC -> AATATAGTTCG
GACCCCCTCCA -> ACCCCCTCCAT
GTACTTCTAGG -> TACTTCTAGGT
GCCTACGGCAG -> CCTACGGCAGT
CTCGCGTCCAA -> TCGCGTCCAAC
GTACCCGGTCG -> TACCCGGTCGT
CACAATACCAG -> ACAATACCAGA
GCAATAATGCC -> CAATAATGCCA
TTGACAGGGAG -> TGACAGGGAGT
ATGCCAGACCC -> TGCCAGACCCC
CTTCTAGAGCA -> TTCTAGAGCAG
TCCGGGAACCG -> CCGGGAACCGC
GTCCTTCTAGA -> TCCTTCTAGAG
TGCACAGATAG -> GCACAGATAGG
ATTAAGCACTG -> TTAAGCACTGC
TAGCACCTGTT -> AGCACCTGTTG
CTACCGCTGGG -> TACCGCTGGGT
CAACGCGCACA -> AACGCGCACAT
ACCACGGTTAC -> CCACGGTTACA
CAGTTGGCGCT -> AGTTGGCGCTA
GTGTATGTGCT -> TGTATGTGCTG
TAATCACCACG -> AATCACCACGG
GAAAATTACGC -> AAAATTACGCG
GCAGATTTGTT -> CAGATTTGTTT
GGCACAGCAGA -> GCACAGCAGAA
CCTTGATTCGT -> CTTGATTCGTG
TTGTATCCGGA -> TGTATCCGGAG
AAATGTGGTTA -> AATGTGGTTAT
CGGCGGTTCCA -> GGCGGTTCCAG
TATTTTTGTAT -> ATTTTTGTATC
TCGGTAAAATG -> CGGTAAAATGA
TTTACGTTTGG -> TTACGTTTGGT
CTGGCGAGTGA -> TGGCGAGTGAG
CTTGCACAGAT -> TTGCACAGATA
ACCCAAGTAAT -> CCCAAGTAATG
GCGTACGGGGC -> CGTACGGGGCG
CGGTAAAATGA -> GGTAAAATGAA
TGTCCTTCTAG -> GTCCTTCTAGA
CAGTGGCCAGC -> AGTGGCCAGCA
AGAATCACTGG -> GAATCACTGGC
TAATAAATTTC -> AATAAATTTCA
ATTGCGGGCAA -> TTGCGGGCAAT
AGTGATCGCAT -> GTGATCGCATG
GCGCAACGCGC -> CGCAACGCGCA
GGCCGTGCTTA -> GCCGTGCTTAC
TCTGAGTTCCC -> CTGAGTTCCCT
GCACTCACCGG -> CACTCACCGGT
AACTACTTATA -> ACTACTTATAG
ATCAATTGCGG -> TCAATTGCGGC
AGGCTCGGTGG -> GGCTCGGTGGC
ATGCGAGTATT -> TGCGAGTATTG
CCAGTATCGAT -> CAGTATCGATC
GCCCTCCAGTG -> CCCTCCAGTGC
CGTCCTGTCTA -> GTCCTGTCTAT
TTGATTAGGAT -> TGATTAGGATT
TCGTGAACTTA -> CGTGAACTTAT
TTATAAATGGC -> TATAAATGGCC
CTACCATGATA -> TACCATGATAG
AACCCAAGTAA -> ACCCAAGTAAT
TTTGTATCAGG -> TTGTATCAGGC
CTGACTTGGTA -> TGACTTGGTAT
GACAGGGAGTG -> ACAGGGAGTGG
TGATCTATCTC -> GATCTATCTCA
ATGAAGCTTAC -> TGAAGCTTACG
ACGAGATCGTG -> CGAGATCGTGA
TGCTTCGGTAA -> GCTTCGGTAAA
TGGTTATTAGC -> GGTTATTAGCA
GAGAGGCATAC -> AGAGGCATACC
GGTGATTTGCA -> GTGATTTGCAC
ACATCAATTGC -> CATCAATTGCG
TTACCTCGAGT -> TACCTCGAGTT
TAGTCTTCGCA -> AGTCTTCGCAC
TCCTCCTTACC -> CCTCCTTACCG
AGGCTTGCACA -> GGCTTGCACAG
CCTAGGCACAG -> CTAGGCACAGC
CTCACCGGTAC -> TCACCGGTACA
AGTGGTCCGGG -> GTGGTCCGGGA
CACTACGCAAC -> ACTACGCAACG
GATCTATCTCA -> ATCTATCTCAT
CAGTCTGCATC -> AGTCTGCATCC
TTCTCTTCCGT -> TCTCTTCCGTT
AGCCTGCTTCG -> GCCTGCTTCGG
GAGCAGTACCC -> AGCAGTACCCG
AGTACCCGGTC -> GTACCCGGTCG
TTGAACCGCAG -> TGAACCGCAGG
ACCTATGGTAC -> CCTATGGTACC
TCACGTGCTGC -> CACGTGCTGCG
TGCATCCTTGA -> GCATCCTTGAT
TATCCGGAGGG -> ATCCGGAGGGG
CTCATTGGCAG -> TCATTGGCAGC
CAGTCACCTGC -> AGTCACCTGCC
ATATCACATAA -> TATCACATAAT
TCATAGATTGA -> CATAGATTGAT
TACCTTTACGT -> ACCTTTACGTC
ACGCAACGCGT -> CGCAACGCGTC
TCCATTCTGAC -> CCATTCTGACT
TACGTTTGGTG -> ACGTTTGGTGA
CCCTAAGGCTT -> CCTAAGGCTTG
GAGGGTGTCGA -> AGGGTGTCGAT
GGTTCAGATGT -> GTTCAGATGTT
GGACGCTACTC -> GACGCTACTCA
CCGGTACACCG -> CGGTACACCGA
ATATTGTATCC -> TATTGTATCCG
GATTTGCACTA -> ATTTGCACTAA
GTTTCACACGG -> TTTCACACGGC
CAGAATCACTG -> AGAATCACTGG
GCCTAGGCACA -> CCTAGGCACAG
AGTATCGATCA -> GTATCGATCAA
ATAACGGTCAG -> TAACGGTCAGT
GGGTTTACGTT -> GGTTTACGTTT,GGTTTACGTTG
GTCCTGTCAAC -> TCCTGTCAACA
TTTTGTGTGTA -> TTTGTGTGTAA
TGACTACCATG -> GACTACCATGA
CCTAATCACCA -> CTAATCACCAC
CTATTTTCATC -> TATTTTCATCA
CATCCTTGATT -> ATCCTTGATTC
CAAGATACTCA -> AAGATACTCAA
GCGCACATGGC -> CGCACATGGCC
TTGATAAAGAC -> TGATAAAGACC
AAGGCTTGCAC -> AGGCTTGCACA
CGACTGTTGCT -> GACTGTTGCTG
AACCTACGCCA -> ACCTACGCCAG
ATTGATAAAGA -> TTGATAAAGAC
TATGCCTCGCG -> ATGCCTCGCGT
TGGCAAATGCG -> GGCAAATGCGA
AGCTTACATGT -> GCTTACATGTC
CGTGTATATGT -> GTGTATATGTC
CCCGGTCGTGT -> CCGGTCGTGTA
TCTCCCTCGGA -> CTCCCTCGGAC
CTAGCGTTTAA -> TAGCGTTTAAG
GCCTCTCAGAC -> CCTCTCAGACC
CCAGAGGAGCA -> CAGAGGAGCAC
AATGTAAAAAC -> ATGTAAAAACG
ATAGGGTGCGC -> TAGGGTGCGCG
GCCACCACGGT -> CCACCACGGTT
AGAGGAGCACA -> GAGGAGCACAT
GGCGAGTGAGA -> GCGAGTGAGAA
CACAGCAGAAG -> ACAGCAGAAGC
TACACCGCGAC -> ACACCGCGACC
TATAAAACTCT -> ATAAAACTCTC
CAACCAAACCT -> AACCAAACCTA
AGTTCCTCCTT -> GTTCCTCCTTA
TCTGCTTGGTG -> CTGCTTGGTGT
ACATGTCTGCG -> CATGTCTGCGA
AGACCTAAGAC -> GACCTAAGACT
CTTGGTGTACA -> TTGGTGTACAG
GATTGGGTGAT -> ATTGGGTGATT
ATTTTCACGTG -> TTTTCACGTGA
TACGCATGCCA -> ACGCATGCCAA
GAATCTTATAT -> AATCTTATATC
GTTATATTATA -> TTATATTATAA
TATGTCTAAGT -> ATGTCTAAGTA
GCAGTCACCTG -> CAGTCACCTGC
TAACCCAAGTA -> AACCCAAGTAA
ACGGAGTGTAT -> CGGAGTGTATG
CTTATAAATGG -> TTATAAATGGC
AACTCTCACGT -> ACTCTCACGTG
TACGCGGGTCA -> ACGCGGGTCAC
ACTCTAATGTT -> CTCTAATGTTA
ATAAAGACCGC -> TAAAGACCGCA
TGTTAAGCTGG -> GTTAAGCTGGC
GTTCCTCCTTA -> TTCCTCCTTAC
TCAAGAATAAT -> CAAGAATAATG
ATGGTCCCAAG -> TGGTCCCAAGG
TTGCACTTATG -> TGCACTTATGC
TGCGACCCGCT -> GCGACCCGCTA
CTACTGCATCC -> TACTGCATCCT
GCCCAGGCCGT -> CCCAGGCCGTC
CTTACATGTCT -> TTACATGTCTG
ATATAGTTCGT -> TATAGTTCGTT
TGTTATGGCGC -> GTTATGGCGCA
CTGAAGCGTGA -> TGAAGCGTGAG
ACCAAACCTAC -> CCAAACCTACG
CATATCGGCGG -> ATATCGGCGGC
CTTGATTCGTG -> TTGATTCGTGG
CCTGCCCGTCC -> CTGCCCGTCCT
ACAGTTGGCGC -> CAGTTGGCGCT
AAACTTTCCAG -> AACTTTCCAGA
GATGTACTTCT -> ATGTACTTCTA
TCAATTGCGGC -> CAATTGCGGCT
CTTGATCCGCC -> TTGATCCGCCC
AGAGGCATACC -> GAGGCATACCT
ACCGTTCTCCC -> CCGTTCTCCCT
CCTTATCTTTC -> CTTATCTTTCA
TTCACGTGATC -> TCACGTGATCA
CCTACCAGCTT -> CTACCAGCTTG
TAAGTCTACAC -> AAGTCTACACC
GGATAATTTGC -> GATAATTTGCA
TCGGTGGCCTC -> CGGTGGCCTCT
GAGGAATCTTA -> AGGAATCTTAT
AATCACCACGG -> ATCACCACGGA
AGTCTGCATCC -> GTCTGCATCCA
CTTCGCACGAG -> TTCGCACGAGA
ACCCCATGGCA -> CCCCATGGCAA
TCTACACCGCG -> CTACACCGCGA
CTCCTTACCGA -> TCCTTACCGAC
CAGAAGCATAT -> AGAAGCATATA
TGATTAGGATT -> GATTAGGATTC
AATGTTATGCT -> ATGTTATGCTC
TATCTCATAAG -> ATCTCATAAGA
GGGGCGTGCTG -> GGGCGTGCTGA
AAAGTCCTGCC -> AAGTCCTGCCC
CGCTACAACAA -> GCTACAACAAG
GCCCATATCGG -> CCCATATCGGC
GCTACTCACGG -> CTACTCACGGC
CGCGTCGGGTT -> GCGTCGGGTTG
CTAAGTAACTA -> TAAGTAACTAG
CAGTACCCGGT -> AGTACCCGGTC
AATACCAGAGG -> ATACCAGAGGA
GTAATGTATTG -> TAATGTATTGC
AACGCGTCGGG -> ACGCGTCGGGT
GGTGTTAAGCT -> GTGTTAAGCTG
ATGTGCCCAGA -> TGTGCCCAGAA
ACCTAAGACTT -> CCTAAGACTTG
GAACTTATAAA -> AACTTATAAAT
TGGTGTTAAGC -> GGTGTTAAGCT
TAACTAGTCTT -> AACTAGTCTTC
CGGCGAGCCCA -> GGCGAGCCCAT
GCATCCTTGAT -> CATCCTTGATT
CGCGCTCTTGC -> GCGCTCTTGCT
CCATGATAGTA -> CATGATAGTAG
CGTACGGGGCG -> GTACGGGGCGT
CCTTTACGTCG -> CTTTACGTCGT
GATAGTAGAGC -> ATAGTAGAGCC
GTAGAGCCACC -> TAGAGCCACCA
CAAACTTTCCA -> AAACTTTCCAG
AAGTTACTTTT -> AGTTACTTTTA
ATGTACTTCTA -> TGTACTTCTAG
GGACGGACGGT -> GACGGACGGTT
AGACCGCAATG -> GACCGCAATGA
GCGTCACGATG -> CGTCACGATGC
CCTGCTTCGGT -> CTGCTTCGGTA
CGACCCGGGAT -> GACCCGGGATA
AGTTACTTTTA -> GTTACTTTTAT
GACGAGGCTCG -> ACGAGGCTCGG
CCTGACGGTCA -> CTGACGGTCAC
TGGTATCCATA -> GGTATCCATAT
GCTTGATTAGG -> CTTGATTAGGA
TTTATGAAAAT -> TTATGAAAATT
TGTGGTTATTA -> GTGGTTATTAG
GTGAGGACGGA -> TGAGGACGGAC
TCCCTAAGGCT -> CCCTAAGGCTT
ATGACCTATAG -> TGACCTATAGC
CAACACAAAAA -> AACACAAAAAT
ACATTCATCGA -> CATTCATCGAG
TCCCAAGGATC -> CCCAAGGATCC
ACGGTCACACC -> CGGTCACACCT
ACTTGACTTAG -> CTTGACTTAGG
ATGGTACCTTT -> TGGTACCTTTA
TCTACTGCATC -> CTACTGCATCC
GGCCTAGGCAC -> GCCTAGGCACA
GCCTAATCACC -> CCTAATCACCA
TCTAGCCCTCC -> CTAGCCCTCCA
CCGCCTACGGC -> CGCCTACGGCA
GGGGTGGAGTC -> GGGTGGAGTCT
GTGTACAGCCA -> TGTACAGCCAG
TTCTAGCCATG -> TCTAGCCATGG
TAATGTTATGC -> AATGTTATGCT
CGCAACGCGCA -> GCAACGCGCAC
TCTCATTGGCA -> CTCATTGGCAG
GCATATATTGT -> CATATATTGTC
TCGCATGGCTC -> CGCATGGCTCC
GCTCTGTCTGA -> CTCTGTCTGAG
ACGTGGCTTTA -> CGTGGCTTTAG
ATAAGAGACTC -> TAAGAGACTCT
TCAGCACTTAC -> CAGCACTTACG
GGTTTACGTTG -> GTTTACGTTGA
GGTTACACTAC -> GTTACACTACG
CACCACGGTTA -> ACCACGGTTAC
CTGGGTTCCTT -> TGGGTTCCTTA
GGTTTACGTTT -> GTTTACGTTTG
TACGTTGAAGG -> ACGTTGAAGGG
ATAGGTTACGG -> TAGGTTACGGA
ATGCTTACATA -> TGCTTACATAA
ACGGCGAGCCC -> CGGCGAGCCCA
TACGCCAGTTA -> ACGCCAGTTAT
GCCTTACTGTG -> CCTTACTGTGC
GTATCCATATT -> TATCCATATTG
ATCTACTGCAT -> TCTACTGCATC
TGGGCCGTTGA -> GGGCCGTTGAA
ATAATGACCTA -> TAATGACCTAT
AGCCATGGTCC -> GCCATGGTCCC
AGCTTACGGCC -> GCTTACGGCCT
CTTCTAGGTGA -> TTCTAGGTGAG
AAGCATACATC -> AGCATACATCA
GACTGGGCGCA -> ACTGGGCGCAG
CAGATGTTATG -> AGATGTTATGG
ACCCGGTCGTG -> CCCGGTCGTGT
GTCAACACAAA -> TCAACACAAAG
CTACGGCAGTG -> TACGGCAGTGG
AGGCCGTCCTG -> GGCCGTCCTGT
GTCAGTGGCCA -> TCAGTGGCCAG
TACAGTTGGCG -> ACAGTTGGCGC
CTCCATTCTGA -> TCCATTCTGAC
ATGGCGCACCC -> TGGCGCACCCC
CAGTGGTTGCA -> AGTGGTTGCAT
TCTCTTCCGTT -> CTCTTCCGTTC
CTGTTGCGCCA -> TGTTGCGCCAT
TGGTGATGCAT -> GGTGATGCATA
GCCAGACCCCC -> CCAGACCCCCT
TAAAATGAAGC -> AAAATGAAGCT
CCGACTGTTGC -> CGACTGTTGCT
TTTGTGTGTAA -> TTGTGTGTAAG
GAGTGAGAACA -> AGTGAGAACAG
AGAGCCACCAC -> GAGCCACCACG
GGCATACCTAC -> GCATACCTACC
CGCAATGATGT -> GCAATGATGTA
AAAATGAAGCT -> AAATGAAGCTT
ACCTTTACGTC -> CCTTTACGTCG
CGCAGTTATAT -> GCAGTTATATT
TGCTGCGCTGA -> GCTGCGCTGAA
CCCGTCCTGTC -> CCGTCCTGTCT
TATGAAAATTA -> ATGAAAATTAC
ACGGTCAGTGA -> CGGTCAGTGAT
GCATACCTACC -> CATACCTACCT
ATTATCCCGTC -> TTATCCCGTCA
CTTCGGTAAAA -> TTCGGTAAAAT
AGACTCTAATG -> GACTCTAATGT
TGGCGATCTTG -> GGCGATCTTGA
CATGGCGCACC -> ATGGCGCACCC
ATATCCCTACC -> TATCCCTACCG
GGTGAGGGGGG -> GTGAGGGGGGT
GATCTAGCCCT -> ATCTAGCCCTC
TCCGCCCACTT -> CCGCCCACTTA
AGGTGAGGGGG -> GGTGAGGGGGG
TGGCCGTGACG -> GGCCGTGACGA
TGTCTGCGACC -> GTCTGCGACCC
CATGGCTCCAA -> ATGGCTCCAAC
CGGTATTTTTG -> GGTATTTTTGT
ACCGCTGGGTT -> CCGCTGGGTTC
ACCCGCTAACC -> CCCGCTAACCC
ACAGCCAGAGG -> CAGCCAGAGGA
GACAACCAAAC -> ACAACCAAACC
GAGTGGTCCGG -> AGTGGTCCGGG
CGTCAGTGGCC -> GTCAGTGGCCA
GAGCCCGAGTC -> AGCCCGAGTCT
TATATCACATA -> ATATCACATAA
TGCTGCTCTGT -> GCTGCTCTGTC
GACCTATAGCC -> ACCTATAGCCT
AGAAGCATATA -> GAAGCATATAT
ATTTCAGCACT -> TTTCAGCACTT
CCCAAGGATCC -> CCAAGGATCCA
CGAGCCCGAGT -> GAGCCCGAGTC
CTAACATCCAT -> TAACATCCATT
CGCGCACATGG -> GCGCACATGGC
CGCCTATCTTG -> GCCTATCTTGA
TTTAAGCTTAC -> TTAAGCTTACA
CGATGCAGGCA -> GATGCAGGCAC
CAGGCACTCAT -> AGGCACTCATC
GGCTCCAACTG -> GCTCCAACTGA
CGCATGGCTCC -> GCATGGCTCCA
CCCGTCAGTGG -> CCGTCAGTGGC
CGTGATCTATC -> GTGATCTATCT
CCCGCCTACGG -> CCGCCTACGGC
CCATATCGGCG -> CATATCGGCGG
GTGAGAACAGC -> TGAGAACAGCT
AGTATTGAATG -> GTATTGAATGC
CTTATCTTTCA -> TTATCTTTCAT
CGTTCTGCTTG -> GTTCTGCTTGG
TAGGGTGCGCG -> AGGGTGCGCGC
AAGGGATTGGG -> AGGGATTGGGT
GCCACAAGATA -> CCACAAGATAC
TGCTAGGCCGC -> GCTAGGCCGCT
CCATATTGTAT -> CATATTGTATC
CCCCCTCCATT -> CCCCTCCATTC
CACATGGCCCA -> ACATGGCCCAA
AAGTAATGTAT -> AGTAATGTATT
TTGCACTAAAG -> TGCACTAAAGA
TACCCGGTCGT -> ACCCGGTCGTG
GTACAGCCAGA -> TACAGCCAGAG
CGGAGGGGTGG -> GGAGGGGTGGA
TTATGAAAGTC -> TATGAAAGTCT
AGTTCGTTTTG -> GTTCGTTTTGT
ATATTATAAAA -> TATTATAAAAC
GTTGCTGCTCT -> TTGCTGCTCTG
GCACTCATCAT -> CACTCATCATA
CCCTACCGCTG -> CCTACCGCTGG
CACGGCGGTTC -> ACGGCGGTTCC
TCCCGTCAGTG -> CCCGTCAGTGG
AGTGCTAGGCC -> GTGCTAGGCCG
CTAACCCAAGT -> TAACCCAAGTA
TACATTCATCG -> ACATTCATCGA
GATTAGGATTC -> ATTAGGATTCA
GCCAGCACTCA -> CCAGCACTCAC
AGCCCGAGTCT -> GCCCGAGTCTC
TGCACTAAAGA -> GCACTAAAGAC
TTATGTAAATG -> TATGTAAATGG
TTAAGCACTGC -> TAAGCACTGCC
GCACATGGCCC -> CACATGGCCCA
CGGCGGCGACT -> GGCGGCGACTG
TCACGCCTATC -> CACGCCTATCT
ATCTAGCCCTC -> TCTAGCCCTCC
AACAGCTCTTC -> ACAGCTCTTCA
TACTGCATCCT -> ACTGCATCCTT
TGCATACCCGC -> GCATACCCGCC
TCGGGTTGAGA -> CGGGTTGAGAT
GCACTAAAGAC -> CACTAAAGACT
CTCCAACTGAC -> TCCAACTGACC
GATTTGTTTCA -> ATTTGTTTCAC
CATAATAAATT -> ATAATAAATTT
CCACCACGGTT -> CACCACGGTTA
ATACCCGCCTA -> TACCCGCCTAC
GTTTTGTGTGT -> TTTTGTGTGTA
TCCTTGATTCG -> CCTTGATTCGT
CTACACCGCGA -> TACACCGCGAC
GTCACCTGCCT -> TCACCTGCCTA
CTTTCCAGAGC -> TTTCCAGAGCA
TGACTTGGTAT -> GACTTGGTATG
CTACTCACGGC -> TACTCACGGCA
CTATATCCCTA -> TATATCCCTAC
GTTTAAGCTTA -> TTTAAGCTTAC
TATATTGTCCT -> ATATTGTCCTT
CGGCTCTGGAC -> GGCTCTGGACG
TTTCAGCACTT -> TTCAGCACTTA
CACTTATGCCT -> ACTTATGCCTC
AGTCTAACATC -> GTCTAACATCC
TCTGCATCCAA -> CTGCATCCAAC
ACACCGACCAA -> CACCGACCAAA
TATATGTCTAA -> ATATGTCTAAG
CCAGTGCTAGG -> CAGTGCTAGGC
AAGCTTACATG -> AGCTTACATGT
TCAGGAGGGTG -> CAGGAGGGTGT
GGGCGGTATTT -> GGCGGTATTTT
AGACCCCCTCC -> GACCCCCTCCA
TGCTTACAGTT -> GCTTACAGTTG
GTATGTGCTGC -> TATGTGCTGCC
CACTGCCACTT -> ACTGCCACTTC
GGGCGTGCTGA -> GGCGTGCTGAG
TTACATGTCTG -> TACATGTCTGC
TCCATTATCCC -> CCATTATCCCG
ATCCCGTCAGT -> TCCCGTCAGTG
TACATAATGTA -> ACATAATGTAA
TGCCAGACCCC -> GCCAGACCCCC
CACTCACCGGT -> ACTCACCGGTA
ATATATTGTCC -> TATATTGTCCT
TTCGTGGCTCT -> TCGTGGCTCTG
TGATCGCATGG -> GATCGCATGGC
GCAGTGGTTGC -> CAGTGGTTGCA
ATGGGCGGTAT -> TGGGCGGTATT
ATTCATCGAGC -> TTCATCGAGCC
CAGGGAGTGGT -> AGGGAGTGGTC
TTGCGGGCAAT -> TGCGGGCAATA
GACTTAGGCCT -> ACTTAGGCCTG
GTGATGCATAT -> TGATGCATATC
ATGGCAAATGC -> TGGCAAATGCG
CACTGGCGATC -> ACTGGCGATCT
ATCGCATGGCT -> TCGCATGGCTC
GTCACGTGATC -> TCACGTGATCT
TGAGGACGGAC -> GAGGACGGACG
GTGGAGTCTAA -> TGGAGTCTAAC
TGCTGATATGG -> GCTGATATGGG
CTTGCAGATTT -> TTGCAGATTTG
CTAAGACTTGA -> TAAGACTTGAC
GTGCTGCGCTG -> TGCTGCGCTGA
TGCCTAATCAC -> GCCTAATCACC
TACTTCTAGGT -> ACTTCTAGGTG
GCGGCGACTGG -> CGGCGACTGGG
AGAATATAGTT -> GAATATAGTTC
ACATAATGTAA -> CATAATGTAAA
GCAACGCGCAC -> CAACGCGCACA
CACTAAAGACT -> ACTAAAGACTT
TTATATCACAT -> TATATCACATA
GCTACGATGCC -> CTACGATGCCA
TAGGTTACGGA -> AGGTTACGGAG
CATTAAGCACT -> ATTAAGCACTG
CGATCAAATAA -> GATCAAATAAG
AACCGCAGGAG -> ACCGCAGGAGC
CCAGCATGGGC -> CAGCATGGGCC
ATATGTCTAAG -> TATGTCTAAGT
ACGGATGGTGT -> CGGATGGTGTT
TAAGGCTTGCA -> AAGGCTTGCAC
ACACTACGCAA -> CACTACGCAAC
TAATTTGCACT -> AATTTGCACTT
CGCTAACCCAA -> GCTAACCCAAG
GGGTGATTTGC -> GGTGATTTGCA
ATGCCAAAGAC -> TGCCAAAGACC
ACGTTTGGTGA -> CGTTTGGTGAT
CCTCCATTCTG -> CTCCATTCTGA
CGTTGGGTTTA -> GTTGGGTTTAC
TGAGATCTAGC -> GAGATCTAGCC
GTTCCTTATCT -> TTCCTTATCTT
CCACGGTTACA -> CACGGTTACAC
GGAACCGCTGC -> GAACCGCTGCT
CTTACAGTTGG -> TTACAGTTGGC
CCTCTCAGACC -> CTCTCAGACCT
CATGCCAAAGA -> ATGCCAAAGAC
TCACACGGCGG -> CACACGGCGGT
ACAGCTCTTCA -> CAGCTCTTCAC
GTGTTAAGCTG -> TGTTAAGCTGG
GTCAGTGATCG -> TCAGTGATCGC
CATATTGTATC -> ATATTGTATCC
TGCACTTATGC -> GCACTTATGCC
GCGTCCAACTA -> CGTCCAACTAC
GTTACGGAGTG -> TTACGGAGTGT
CATGGTCCCAA -> ATGGTCCCAAG
ATGTAAATGGG -> TGTAAATGGGC
GACGCTACTCA -> ACGCTACTCAC
ACTCAAGAATA -> CTCAAGAATAA
CTGCGCTGAAG -> TGCGCTGAAGC
CATCACATACG -> ATCACATACGC
GGCCGTTGAAC -> GCCGTTGAACC
AGAACAGCTCT -> GAACAGCTCTT
ATCCGGAGGGG -> TCCGGAGGGGT
GCAGAAGCATA -> CAGAAGCATAT
TACAACAAGGG -> ACAACAAGGGC
TAGTAGAGCCA -> AGTAGAGCCAC
CGGATGGTATC -> GGATGGTATCC
TCTAGAGCAGT -> CTAGAGCAGTA
ACATACGCATG -> CATACGCATGC
GTAGCAACACA -> TAGCAACACAA
ATATCGGCGGC -> TATCGGCGGCG
TCTAATGTTAT -> CTAATGTTATG
GCAGCGTACGG -> CAGCGTACGGG
GTATTGCGGGC -> TATTGCGGGCA
GAATGCTTACA -> AATGCTTACAT
TGAAGCGTGAG -> GAAGCGTGAGG
GTTTGGTGATG -> TTTGGTGATGC
GCGACTGGGCG -> CGACTGGGCGC
ACAATACCAGA -> CAATACCAGAG
CGGTCACACCT -> GGTCACACCTA
TTGCGCCATTT -> TGCGCCATTTG
TCCTTCTAGAG -> CCTTCTAGAGC
TAATGTATTGC -> AATGTATTGCG
TACATGTCTGC -> ACATGTCTGCG
ATTCTCTTCCG -> TTCTCTTCCGT
TTGACTTAGGC -> TGACTTAGGCC
ATCAGGCGCCA -> TCAGGCGCCAG
ATCCAGATAAC -> TCCAGATAACG
CCAACTACTTA -> CAACTACTTAT
GAAGCATATAT -> AAGCATATATT
AGTAGCAACAC -> GTAGCAACACA
TGAAAATTACG -> GAAAATTACGC
ATCGGCGGCGA -> TCGGCGGCGAC
CCCATGGCAAA -> CCATGGCAAAT
GGCGAGAGGCA -> GCGAGAGGCAT
ATGAAAATTAC -> TGAAAATTACG
CCGGGATAATT -> CGGGATAATTT
CTTTCATTGCT -> TTTCATTGCTG
ATGGGATTTTC -> TGGGATTTTCA
GTGGCTCTGAC -> TGGCTCTGACT
GCATATCTACT -> CATATCTACTG
GAGATCGTGAA -> AGATCGTGAAC
TCTTTCATGGC -> CTTTCATGGCG
TACTCAAGAAT -> ACTCAAGAATA
GGGTCACGTGA -> GGTCACGTGAT
CTCTTCCGTTC -> TCTTCCGTTCT
AATCTTATATC -> ATCTTATATCA
AGCGTTTAAGC -> GCGTTTAAGCT
TTATAGGGTGC -> TATAGGGTGCG
AAAACGGCGAG -> AAACGGCGAGC
GACTGTTGCTG -> ACTGTTGCTGC
ACGTGATCTAT -> CGTGATCTATC
GGGAACCGCTG -> GGAACCGCTGC
TCTTGATCCGC -> CTTGATCCGCC
CGAGTATTGAA -> GAGTATTGAAT
TGTCGATTAGT -> GTCGATTAGTT
GTGTCGATTAG -> TGTCGATTAGT
GATGCAGGCAC -> ATGCAGGCACT
GGCAGTGGTTG -> GCAGTGGTTGC
CAGACCCCCTC -> AGACCCCCTCC
CCGCAATGATG -> CGCAATGATGT
AACACAAAAAT -> ACACAAAAATG
GCCTGCTTCGG -> CCTGCTTCGGT
AGCTCTTCACG -> GCTCTTCACGC
GCTGCCCAGGC -> CTGCCCAGGCC
GTCTGCATCCA -> TCTGCATCCAA
TGTTATGCTCA -> GTTATGCTCAC
GGTGCGCGCTC -> GTGCGCGCTCT
CGTTGAAGGGA -> GTTGAAGGGAT
TGTCTATTTTC -> GTCTATTTTCA
CCAAATGTGCC -> CAAATGTGCCC
TGAAAGTCTTT -> GAAAGTCTTTC
GGTTCCAGCAT -> GTTCCAGCATG
CCTACCGCTGG -> CTACCGCTGGG
GTGGTCCGGGA -> TGGTCCGGGAA
TCACAATACCA -> CACAATACCAG
TTAGTTCCTCC -> TAGTTCCTCCT
TAGAGCCACCA -> AGAGCCACCAC
GGCCAGCACTC -> GCCAGCACTCA
CGAGTGAGAAC -> GAGTGAGAACA
ATGGGCCGTTG -> TGGGCCGTTGA
CCAGAGCACAA -> CAGAGCACAAG
GCATACCCGCC -> CATACCCGCCT
CACCCCATGGC -> ACCCCATGGCA
GTACACCGACC -> TACACCGACCA
GGCGACTGGGC -> GCGACTGGGCG
GGCCGCTGTTA -> GCCGCTGTTAA
ACTCTCACGTG -> CTCTCACGTGC
GTCCAACTACT -> TCCAACTACTT
CGCTGGGTTCC -> GCTGGGTTCCT
ATTGGCAGCGT -> TTGGCAGCGTA
GCCAGAGGAAT -> CCAGAGGAATC
GGCACTCATCA -> GCACTCATCAT
CTATCTTGACG -> TATCTTGACGT
GGTCCGGGAAC -> GTCCGGGAACC
TCCTACCAGCT -> CCTACCAGCTT
TCCTGTCTATT -> CCTGTCTATTT
TCACATAATAA -> CACATAATAAA
GGTCGTGTATA -> GTCGTGTATAT
ACGCCAGTTAT -> CGCCAGTTATG
AGATTGATAAA -> GATTGATAAAG
CAAGGGCGCCT -> AAGGGCGCCTT
ATTTTCATCAC -> TTTTCATCACA
GGGGTTTACGT -> GGGTTTACGTT
GTTACATTCAT -> TTACATTCATC
GCTTGGTGTAC -> CTTGGTGTACA
GCTTACATAAT -> CTTACATAATG
TGCTTACATAA -> GCTTACATAAT
GATCTTGATCC -> ATCTTGATCCG
TCTGACTACCA -> CTGACTACCAT
TGAAGGGATTG -> GAAGGGATTGG
CCCACTTATGA -> CCACTTATGAA
TCATTGGCAGC -> CATTGGCAGCG
CTGGACGCTAC -> TGGACGCTACT
AATGTATTGCG -> ATGTATTGCGG
ATCATAGATTG -> TCATAGATTGA
GACGGTCACAC -> ACGGTCACACC
CTAGGTGAGGG -> TAGGTGAGGGG
CTGCCACTTCT -> TGCCACTTCTA
CAGTATCGATC -> AGTATCGATCA
AGGGATTGGGT -> GGGATTGGGTG
CAAATAAGTTA -> AAATAAGTTAC
GGATTGGGTGA -> GATTGGGTGAT
TTGCAGATTTG -> TGCAGATTTGT
ACCGGTACACC -> CCGGTACACCG
TAAAAACGGCG -> AAAAACGGCGA
ACACCTATGGT -> CACCTATGGTA
AATATAGTTCG -> ATATAGTTCGT
GATTCGTGGCT -> ATTCGTGGCTC
CTGCCTAATCA -> TGCCTAATCAC
CGGTGGCCTCT -> GGTGGCCTCTC
AAACTCTCACG -> AACTCTCACGT
GATGCCACAAG -> ATGCCACAAGA
ATCAAATAAGT -> TCAAATAAGTT
ACAAGGGCGCC -> CAAGGGCGCCT
TTCCCTAAGGC -> TCCCTAAGGCT
GTGGCTTTAGC -> TGGCTTTAGCC
CCGAGTCTCAT -> CGAGTCTCATT
GTGCCCAGAAT -> TGCCCAGAATC
GAGTAGCAACA -> AGTAGCAACAC
CCAGTTATGTA -> CAGTTATGTAA
CAAAGTCCTGC -> AAAGTCCTGCC
ATGTGCTGCCC -> TGTGCTGCCCA
AATTGCGGCTC -> ATTGCGGCTCT
CGCAGGAGCTA -> GCAGGAGCTAG
CATATCTACTG -> ATATCTACTGC
CATAAGAGACT -> ATAAGAGACTC
ATTGGGTGATT -> TTGGGTGATTT
TCACGATGCAG -> CACGATGCAGG
CATTATCCCGT -> ATTATCCCGTC
GTCGGGTTGAG -> TCGGGTTGAGA
AAAATTACGCG -> AAATTACGCGG
CGACCAAATGT -> GACCAAATGTG
ACTTTTATGAA -> CTTTTATGAAA
AGTCTACACCG -> GTCTACACCGC
TCCATATTGTA -> CCATATTGTAT
TTTCATCACAT -> TTCATCACATA
GCACCCCATGG -> CACCCCATGGC
CCAAAGACCCC -> CAAAGACCCCG
TTAGCACCTGT -> TAGCACCTGTT
TAAAACTCTCA -> AAAACTCTCAC
CTTCTAGCCAT -> TTCTAGCCATG
AAATGGGCCGT -> AATGGGCCGTT
TCGTGGCTCTG -> CGTGGCTCTGA
CACGATGCAGG -> ACGATGCAGGC
TATCAGGCGCC -> ATCAGGCGCCA
TGGTACCTTTA -> GGTACCTTTAC
TATCTACTGCA -> ATCTACTGCAT
GAGGCATACCT -> AGGCATACCTA
AACATCCATTA -> ACATCCATTAT
AGCACTGCCAC -> GCACTGCCACT
ACTACGCAACG -> CTACGCAACGC
GACATAGCTAC -> ACATAGCTACG
AGCCAGAGGAA -> GCCAGAGGAAT
TGCTTGATTAG -> GCTTGATTAGG
GAGTCTCATTG -> AGTCTCATTGG
GAGGGGTGGAG -> AGGGGTGGAGT
AAAGACCCCGA -> AAGACCCCGAC
GGGGGTTTACG -> GGGGTTTACGT
TATAAATGGCC -> ATAAATGGCCG
CATAGCTACGA -> ATAGCTACGAT
TCCAGTGCTAG -> CCAGTGCTAGG
TAGCCGGACAT -> AGCCGGACATA
TTGAAGGGATT -> TGAAGGGATTG
CCCAGGCCGTC -> CCAGGCCGTCC
CACCGACCAAA -> ACCGACCAAAT
GATAATTTGCA -> ATAATTTGCAC
GTTATGGCGCA -> TTATGGCGCAA
TTACGGATGGT -> TACGGATGGTG
TGTCTGAGTTC -> GTCTGAGTTCC
TTCTCCCTCGG -> TCTCCCTCGGA
CCTGTTGCGCC -> CTGTTGCGCCA
TCTTCGCACGA -> CTTCGCACGAG
GAGTGTATGTG -> AGTGTATGTGC
CTATCTCATAA -> TATCTCATAAG
ATTGCGGCTCT -> TTGCGGCTCTG
GCTTCGGTAAA -> CTTCGGTAAAA
ATCGTGAACTT -> TCGTGAACTTA
TACGGAGTGTA -> ACGGAGTGTAT
TATCCATATTG -> ATCCATATTGT
CCTCGGACAAC -> CTCGGACAACC
TTCTAGGTGAG -> TCTAGGTGAGG
CGCTACTCACG -> GCTACTCACGG
ACGCGTCGGGT -> CGCGTCGGGTT
AGCCCATATCG -> GCCCATATCGG
TTTGTGCATAC -> TTGTGCATACC
AAAATGTGGTT -> AAATGTGGTTA
TCATTGCTGAT -> CATTGCTGATA
CCTATGGTACC -> CTATGGTACCT
GTTGAAGGGAT -> TTGAAGGGATT
CTGCTCTGTCT -> TGCTCTGTCTG
GTGCTGCCCAG -> TGCTGCCCAGG
ATCTTTCATGG -> TCTTTCATGGC
TTACGGCCTAG -> TACGGCCTAGG
ACCGACCAAAT -> CCGACCAAATG
AATTACGCGGG -> ATTACGCGGGT
TGGCGCACCCC -> GGCGCACCCCA
GCTGATATGGG -> CTGATATGGGC
CAGAGGAATCT -> AGAGGAATCTT
TGACGAGGCTC -> GACGAGGCTCG
CAAAAATGTGG -> AAAAATGTGGT
TATGGGATTTT -> ATGGGATTTTC
ACATTAAGCAC -> CATTAAGCACT
CTGGCGATCTT -> TGGCGATCTTG
TTGATTCGTGG -> TGATTCGTGGC
TGTATCCGGAG -> GTATCCGGAGG
TAAAGACCGCA -> AAAGACCGCAA
CCCGACTTGCG -> CCGACTTGCGT
TAGGTGAGGGG -> AGGTGAGGGGG
TTATATTATAA -> TATATTATAAA
CCTTACTGTGC -> CTTACTGTGCA
AGATGTTATGG -> GATGTTATGGC
TAAATGGCCGT -> AAATGGCCGTG
GACGTGGCTTT -> ACGTGGCTTTA
TGACAGGGAGT -> GACAGGGAGTG
TGGCAGCGTAC -> GGCAGCGTACG
GCACAAGTTAC -> CACAAGTTACC
CCGCAGGAGCT -> CGCAGGAGCTA
GTGTGTAAGTC -> TGTGTAAGTCT
ACGTTGAAGGG -> CGTTGAAGGGA
AGTAATGTATT -> GTAATGTATTG
TACACCGACCA -> ACACCGACCAA
AGGGTGCGCGC -> GGGTGCGCGCT
GGATTCAGGAG -> GATTCAGGAGG
ATTACGCGGGT -> TTACGCGGGTC
TGATCCGCCCA -> GATCCGCCCAC
GTGGTTATTAG -> TGGTTATTAGC
TTGAATGCTTA -> TGAATGCTTAC
TAGGCCGCTGT -> AGGCCGCTGTT
AGAGCAGTACC -> GAGCAGTACCC
CATGGGCCGTG -> ATGGGCCGTGC
CCAAACCTACG -> CAAACCTACGC
CTGAGTTCCCT -> TGAGTTCCCTA
AGCATGGGCCG -> GCATGGGCCGT
ATAGCTACGAT -> TAGCTACGATG
TTGCTGCTCTG -> TGCTGCTCTGT
GCTGCTCTGTC -> CTGCTCTGTCT
CGAGAGGCATA -> GAGAGGCATAC
TGCTCTGTCTG -> GCTCTGTCTGA
CGTGCTGAGTA -> GTGCTGAGTAG
TCCTTACCGAC -> CCTTACCGACT
GGACGGTTCAG -> GACGGTTCAGA
GCGAGCCCATA -> CGAGCCCATAT
CATGTCTGCGA -> ATGTCTGCGAC
CCACTTATGAA -> CACTTATGAAA
TGCGCTGAAGC -> GCGCTGAAGCG
GAGTTACATTC -> AGTTACATTCA
GCTCACAATAC -> CTCACAATACC
CCCGCTAACCC -> CCGCTAACCCA
CTGACGGTCAC -> TGACGGTCACA
TTCCTTATCTT -> TCCTTATCTTT
CCAGCTTGCAG -> CAGCTTGCAGA
GTTCGTTTTGT -> TTCGTTTTGTG
CGAGGCTCGGT -> GAGGCTCGGTG
GCGCTCTTGCT -> CGCTCTTGCTA
CAGGCCGTCCT -> AGGCCGTCCTG
GTCTAAGTAAC -> TCTAAGTAACT
CCGACTTGCGT -> CGACTTGCGTC
CAAAGGCGAGA -> AAAGGCGAGAG
AACGGTCAGTG -> ACGGTCAGTGA
TGGCTCTGACT -> GGCTCTGACTA
GACCGTTCTCC -> ACCGTTCTCCC
AATGACCTATA -> ATGACCTATAG
ACCTAGAACGT -> CCTAGAACGTT
ACCGCGACCCG -> CCGCGACCCGG
CGTTTGGTGAT -> GTTTGGTGATG
TCCGGAGGGGT -> CCGGAGGGGTG
TTCAGGAGGGT -> TCAGGAGGGTG
ATGGCCGTGAC -> TGGCCGTGACG
CCATTATCCCG -> CATTATCCCGT
ACAGCAGAAGC -> CAGCAGAAGCA
ACGGCAAAGGC -> CGGCAAAGGCG
AGCCGGACATA -> GCCGGACATAG
TACAGCCAGAG -> ACAGCCAGAGG
TGATCAGTCTG -> GATCAGTCTGC
CGCCAGTATCG -> GCCAGTATCGA
GGTTCCTTATC -> GTTCCTTATCT
GGACAACCAAA -> GACAACCAAAC
ATCAGTCTGCA -> TCAGTCTGCAT
AGTTGGCGCTA -> GTTGGCGCTAC
TGAACTTATAA -> GAACTTATAAA
CTCACAATACC -> TCACAATACCA
TAGAGCAGTAC -> AGAGCAGTACC
GGCCGTCCTGT -> GCCGTCCTGTC
GGCCTCTCAGA -> GCCTCTCAGAC
AAAACTCTCAC -> AAACTCTCACG
TATTATAAAAC -> ATTATAAAACT
GGATGGTGTTA -> GATGGTGTTAA
TTCGTTTTGTG -> TCGTTTTGTGT
AGTGAGAACAG -> GTGAGAACAGC
GGCGAGCCCAT -> GCGAGCCCATA
CAGTGATCGCA -> AGTGATCGCAT
TTTTATGAAAA -> TTTATGAAAAT
AGGGCGCCTTA -> GGGCGCCTTAC
GCTTGCACAGA -> CTTGCACAGAT
GGTATTTTTGT -> GTATTTTTGTA
GGGCAATAATG -> GGCAATAATGC
ATCTTATATCA -> TCTTATATCAC
ACGGCAGTGGT -> CGGCAGTGGTT
ATCACCACGGA -> TCACCACGGAT
AAATTACGCGG -> AATTACGCGGG
ATTGTCCTTCT -> TTGTCCTTCTA
GAATAATGACC -> AATAATGACCT
TACCAGAGGAG -> ACCAGAGGAGC
TGCTTGGTGTA -> GCTTGGTGTAC
CCCAAGTAATG -> CCAAGTAATGT
CACTTCTAGCC -> ACTTCTAGCCA
GATGGTGTTAA -> ATGGTGTTAAG
TTACGCGGGTC -> TACGCGGGTCA
GCACTTATGCC -> CACTTATGCCT
GCATACATCAA -> CATACATCAAT
GCTCTTGCTAT -> CTCTTGCTATA
GAGAACAGCTC -> AGAACAGCTCT
GGAGGGTGTCG -> GAGGGTGTCGA
CTTATATCACA -> TTATATCACAT
TCATCACATAC -> CATCACATACG
AGTAGAGCCAC -> GTAGAGCCACC
TTATTAGCACC -> TATTAGCACCT
TGTATATGTCT -> GTATATGTCTA
TTACCGACTGT -> TACCGACTGTT
CCTCCTTACCG -> CTCCTTACCGA
TTGCGGCTCTG -> TGCGGCTCTGG
CACGAGATCGT -> ACGAGATCGTG
ACCATGATAGT -> CCATGATAGTA
AGGGGTGGAGT -> GGGGTGGAGTC
AGGAGGGTGTC -> GGAGGGTGTCG
CTACGCCAGTT -> TACGCCAGTTA
GGATGGTATCC -> GATGGTATCCA
ATACCAGAGGA -> TACCAGAGGAG
AGTTACATTCA -> GTTACATTCAT
CCAAGTAATGT -> CAAGTAATGTA
TTGTGCATACC -> TGTGCATACCC
CACATAATAAA -> ACATAATAAAT
GCGAGTGAGAA -> CGAGTGAGAAC
GTCTACACCGC -> TCTACACCGCG
TATTGTATCCG -> ATTGTATCCGG
GGCTTGCACAG -> GCTTGCACAGA
CTGCCCAGGCC -> TGCCCAGGCCG
AGGCATACCTA -> GGCATACCTAC
TAGCCATGGTC -> AGCCATGGTCC
GAACCGCAGGA -> AACCGCAGGAG
GCTGGGTTCCT -> CTGGGTTCCTT
ACCTGTTGCGC -> CCTGTTGCGCC
TCGATCAAATA -> CGATCAAATAA
CTGCATCCAAC -> TGCATCCAACC
GGCGGTATTTT -> GCGGTATTTTT
ATCGATCAAAT -> TCGATCAAATA
AGGAGCACATT -> GGAGCACATTA
AATGAAGCTTA -> ATGAAGCTTAC
TTTGGTGATGC -> TTGGTGATGCA
ATTGTATCCGG -> TTGTATCCGGA
CAGCTTGCAGA -> AGCTTGCAGAT
GTGAACTTATA -> TGAACTTATAA
TACTTTTATGA -> ACTTTTATGAA
TCACACCTATG -> CACACCTATGG
GGCAATAATGC -> GCAATAATGCC
TATAGTTCGTT -> ATAGTTCGTTT
CGGACGGTTCA -> GGACGGTTCAG
CACAAGTTACC -> ACAAGTTACCT
GATTGATAAAG -> ATTGATAAAGA
CACGTGATCAG -> ACGTGATCAGT
CTTATGAAAGT -> TTATGAAAGTC
TGGAGTCTAAC -> GGAGTCTAACA
TCACGTGATCA -> CACGTGATCAG
ACAGGGAGTGG -> CAGGGAGTGGT
CATTCTCTTCC -> ATTCTCTTCCG
TCACGTGATCT -> CACGTGATCTA
TTCCAGAGCAC -> TCCAGAGCACA
TCAGTGATCGC -> CAGTGATCGCA
GCAACACAAAA -> CAACACAAAAA
GGGCCGTTGAA -> GGCCGTTGAAC
TCAGTGGCCAG -> CAGTGGCCAGC
TCCAGAGCACA -> CCAGAGCACAA
GTTCTGCTTGG -> TTCTGCTTGGT
ACCGCAATGAT -> CCGCAATGATG
GGCGCCAGTAT -> GCGCCAGTATC
GAGCTAGCGTT -> AGCTAGCGTTT
TAGCGTTTAAG -> AGCGTTTAAGC
GATGTTATGGC -> ATGTTATGGCG
GCTATATCCCT -> CTATATCCCTA
TCACGGCAAAG -> CACGGCAAAGG
TAGGCCTGACG -> AGGCCTGACGG
TCCTGTCAACA -> CCTGTCAACAC
AATGCGAGTAT -> ATGCGAGTATT
GTCTGAGTTCC -> TCTGAGTTCCC
CAACTGACCGT -> AACTGACCGTT
GGCGCAACGCG -> GCGCAACGCGC
AGTCACCTGCC -> GTCACCTGCCT
GCTAGGCCGCT -> CTAGGCCGCTG
GCGCCAGTATC -> CGCCAGTATCG
GCGTCGGGTTG -> CGTCGGGTTGA
GTGACGAGGCT -> TGACGAGGCTC
CTAATGTTATG -> TAATGTTATGC
TGCAGTCACCT -> GCAGTCACCTG
TTGCACAGATA -> TGCACAGATAG
GGCCCAAACTT -> GCCCAAACTTT
CGCAACGCGTC -> GCAACGCGTCG
CAATGATGTAC -> AATGATGTACT
GGCCTGACGGT -> GCCTGACGGTC
AGGCGCCAGTA -> GGCGCCAGTAT
TGTGCCCAGAA -> GTGCCCAGAAT
CGGTTCAGATG -> GGTTCAGATGT
CCCATATCGGC -> CCATATCGGCG
AGTCTTCGCAC -> GTCTTCGCACG
CACAAGATACT -> ACAAGATACTC
AACTTTCCAGA -> ACTTTCCAGAG
TTTCACGTGAT -> TTCACGTGATC
CCCCGACTTGC -> CCCGACTTGCG
AAGCACTGCCA -> AGCACTGCCAC
TGTTGCTGCTC -> GTTGCTGCTCT
CGACTGGGCGC -> GACTGGGCGCA
GCCGTCCTGTC -> CCGTCCTGTCA
AGATTTGTTTC -> GATTTGTTTCA
ACTTACGGATG -> CTTACGGATGG
ACTAAAGACTT -> CTAAAGACTTG
TTTCATTGCTG -> TTCATTGCTGA
CATCCAACCGA -> ATCCAACCGAC
CCAGGCCGTCC -> CAGGCCGTCCT
ACATAGCTACG -> CATAGCTACGA
CCATTTGTGCA -> CATTTGTGCAT
TTGTGTGTAAG -> TGTGTGTAAGT
TGCCACTTCTA -> GCCACTTCTAG
CGGACATAGCT -> GGACATAGCTA
ACTCATCATAG -> CTCATCATAGA
GGAGGGGTGGA -> GAGGGGTGGAG
CGGCGACTGGG -> GGCGACTGGGC
GACGGTTCAGA -> ACGGTTCAGAT
TGCTATATCCC -> GCTATATCCCT
TGTTGCGCCAT -> GTTGCGCCATT
GGGGGGTTTAC -> GGGGGTTTACG
TAAATGGGCCG -> AAATGGGCCGT
TAGTTCCTCCT -> AGTTCCTCCTT
AACGGCGAGCC -> ACGGCGAGCCC
ATTTGCACTTA -> TTTGCACTTAT
CCTTCTAGAGC -> CTTCTAGAGCA
GTGTATATGTC -> TGTATATGTCT
TGTGCAGTCAC -> GTGCAGTCACC
GTCTGCGACCC -> TCTGCGACCCG
TTATGCTCACA -> TATGCTCACAA
CAAGTTACCTC -> AAGTTACCTCG
TGCCTCGCGTC -> GCCTCGCGTCC
GCACAGCAGAA -> CACAGCAGAAG
ATGGGCCGTGC -> TGGGCCGTGCT
ATAATTTGCAC -> TAATTTGCACT
TACGCAACGCG -> ACGCAACGCGT
AATTTCAGCAC -> ATTTCAGCACT
TATCGATCAAA -> ATCGATCAAAT
GTTGAGATCTA -> TTGAGATCTAG
GATATGGGCGG -> ATATGGGCGGT
CGTCGGGTTGA -> GTCGGGTTGAG
AGGACGGACGG -> GGACGGACGGT
ATACTCAAGAA -> TACTCAAGAAT
GGAATCTTATA -> GAATCTTATAT
CGGGATAATTT -> GGGATAATTTG
TATGTAAATGG -> ATGTAAATGGG
TAAAGCATACA -> AAAGCATACAT
TCTTCCGTTCT -> CTTCCGTTCTG
CCCAAACTTTC -> CCAAACTTTCC
CACTTATGAAA -> ACTTATGAAAG
GACTTGACAGG -> ACTTGACAGGG
CTCTTCACGCC -> TCTTCACGCCT
TACGGATGGTG -> ACGGATGGTGT
TCAGGCGCCAG -> CAGGCGCCAGT
AGGGGGGTTTA -> GGGGGGTTTAC
TACATCAATTG -> ACATCAATTGC
GTTATTAGCAC -> TTATTAGCACC
CCAGAGGAATC -> CAGAGGAATCT
TGCAGGCACTC -> GCAGGCACTCA
CAGTTATGTAA -> AGTTATGTAAA
CGTCCTGTCAA -> GTCCTGTCAAC
AGAGGAATCTT -> GAGGAATCTTA
TGGTGTACAGC -> GGTGTACAGCC
GCGCCTTACTG -> CGCCTTACTGT
CGCACATGGCC -> GCACATGGCCC
ATGTTATGGCG -> TGTTATGGCGC
GAGCACAAGTT -> AGCACAAGTTA
CTAGAGCAGTA -> TAGAGCAGTAC
CATTCATCGAG -> ATTCATCGAGC
AATGTGGTTAT -> ATGTGGTTATT
GTCACACCTAT -> TCACACCTATG
CACGTGCTGCG -> ACGTGCTGCGC
GGATTTTCACG -> GATTTTCACGT
CGGCAAAGGCG -> GGCAAAGGCGA
TTATCTTTCAT -> TATCTTTCATG
GCAGTTATATT -> CAGTTATATTA
ACGTGCTGCGC -> CGTGCTGCGCT
GGAGCACATTA -> GAGCACATTAA
GGCGATCTTGA -> GCGATCTTGAT
GTGAGGGGGGT -> TGAGGGGGGTT
CACAAAAATGT -> ACAAAAATGTG
TACCGACTGTT -> ACCGACTGTTG
CACTTACGGAT -> ACTTACGGATG
ACGGTTACACT -> CGGTTACACTA
TACCGCTGGGT -> ACCGCTGGGTT
GATCAAATAAG -> ATCAAATAAGT
CAGGAGCTAGC -> AGGAGCTAGCG
ACCTATAGCCT -> CCTATAGCCTG
GCATGGCTCCA -> CATGGCTCCAA
ACTGTGCAGTC -> CTGTGCAGTCA
TCACCGGTACA -> CACCGGTACAC
GCGATCTTGAT -> CGATCTTGATC
CACAGATAGGT -> ACAGATAGGTT
CCGCTGTTAAA -> CGCTGTTAAAG
TTCACGCCTAT -> TCACGCCTATC
ACTACCATGAT -> CTACCATGATA
TCGTGTATATG -> CGTGTATATGT
ATTGAATGCTT -> TTGAATGCTTA
AGCTACGATGC -> GCTACGATGCC
TTATAAAACTC -> TATAAAACTCT
GCAAAGGCGAG -> CAAAGGCGAGA
GTGGTTGCATT -> TGGTTGCATTC
TTACTTTTATG -> TACTTTTATGA
TGTAAATGGGC -> GTAAATGGGCC
CTGCGACCCGC -> TGCGACCCGCT
AGAGACTCTAA -> GAGACTCTAAT
AAATGAAGCTT -> AATGAAGCTTA
CCTCGCGTCCA -> CTCGCGTCCAA
CATATATTGTC -> ATATATTGTCC
TTCAGCACTTA -> TCAGCACTTAC
TTTTCATCACA -> TTTCATCACAT
TGACGGTCACA -> GACGGTCACAC
CCGCCCACTTA -> CGCCCACTTAT
ATAGATTGATA -> TAGATTGATAA
TATGCTCACAA -> ATGCTCACAAT
TGTATGTGCTG -> GTATGTGCTGC
GACCTAAGACT -> ACCTAAGACTT
AGAGCACAAGT -> GAGCACAAGTT
ATCTTGATCCG -> TCTTGATCCGC
CAGACCTAAGA -> AGACCTAAGAC
CTCGGTGGCCT -> TCGGTGGCCTC
AAAGGCGAGAG -> AAGGCGAGAGG
AATGATGTACT -> ATGATGTACTT
AATTTGCACTT -> ATTTGCACTTA
TGAGTAGCAAC -> GAGTAGCAACA
ACAGATAGGTT -> CAGATAGGTTA
AGTCTCATTGG -> GTCTCATTGGC
GCCAAAGACCC -> CCAAAGACCCC
TCTGCGACCCG -> CTGCGACCCGC
GCAGGAGCTAG -> CAGGAGCTAGC
TCCTGCCCGTC -> CCTGCCCGTCC
GCGGGTCACGT -> CGGGTCACGTG
CTGCTTGGTGT -> TGCTTGGTGTA
TGTATCAGGCG -> GTATCAGGCGC
AAAGACCGCAA -> AAGACCGCAAT
ACCTCGAGTTA -> CCTCGAGTTAC
ACCAGCTTGCA -> CCAGCTTGCAG
CGAGATCGTGA -> GAGATCGTGAA
GGGATTGGGTG -> GGATTGGGTGA
TGCCCAGAATC -> GCCCAGAATCA
GCCGTGCTTAC -> CCGTGCTTACA
TCCCTACCGCT -> CCCTACCGCTG
GGTATGGGATT -> GTATGGGATTT
GATGCATATCT -> ATGCATATCTA
CTCAGACCTAA -> TCAGACCTAAG
GATAGGTTACG -> ATAGGTTACGG
GTATTTTTGTA -> TATTTTTGTAT
CTAGTCTTCGC -> TAGTCTTCGCA
CGATCTTGATC -> GATCTTGATCC
GTTATGTAAAT -> TTATGTAAATG
CTTACCGACTG -> TTACCGACTGT
TTGGGTGATTT -> TGGGTGATTTG
TTGCTATATCC -> TGCTATATCCC
GGTACCTTTAC -> GTACCTTTACG
TACCTACCTAG -> ACCTACCTAGA
ATAGCCTGCTT -> TAGCCTGCTTC
ACCACGGATGG -> CCACGGATGGT
GCTCTGACTAC -> CTCTGACTACC
ATGCAGGCACT -> TGCAGGCACTC
TAAATTTCAGC -> AAATTTCAGCA
CTACGATGCCA -> TACGATGCCAC
TGAGGGGGGTT -> GAGGGGGGTTT
TAACGGTCAGT -> AACGGTCAGTG
CCAAACTTTCC -> CAAACTTTCCA
CTTATAGGGTG -> TTATAGGGTGC
CATTCTGACTT -> ATTCTGACTTG
AGGCGAGAGGC -> GGCGAGAGGCA
ACGGGGCGTGC -> CGGGGCGTGCT
GTTGGCGCTAC -> TTGGCGCTACA
TCACTGGCGAT -> CACTGGCGATC
CCCCATGGCAA -> CCCATGGCAAA
TCTTCACGCCT -> CTTCACGCCTA
TGAAGCTTACG -> GAAGCTTACGG
CTGTTAAAGCA -> TGTTAAAGCAT
TATGAAAGTCT -> ATGAAAGTCTT
TAGATTGATAA -> AGATTGATAAA
CGTGCTGCGCT -> GTGCTGCGCTG
TACCCGCCTAC -> ACCCGCCTACG
ACTGTTGCTGC -> CTGTTGCTGCT
CGTGACGAGGC -> GTGACGAGGCT
CAAACCTACGC -> AAACCTACGCC
GTCGATTAGTT -> TCGATTAGTTC
CTCCCTCGGAC -> TCCCTCGGACA
CACGTGATCTA -> ACGTGATCTAT
CTAGCCATGGT -> TAGCCATGGTC
ACCTGCCTAAT -> CCTGCCTAATC
TCAACACAAAG -> CAACACAAAGT
GCGAGAGGCAT -> CGAGAGGCATA
TTGGTGATGCA -> TGGTGATGCAT
GACTTGACTTA -> ACTTGACTTAG
GTAAGTCTACA -> TAAGTCTACAC
CAAAGACCCCG -> AAAGACCCCGA
CATCGAGCCCG -> ATCGAGCCCGA
ATCTATCTCAT -> TCTATCTCATA
CATAGATTGAT -> ATAGATTGATA
AGCACCTGTTG -> GCACCTGTTGC
AGCCCTCCAGT -> GCCCTCCAGTG
GTCTTTCATTG -> TCTTTCATTGC
AAGTCTTTCAT -> AGTCTTTCATT
GGTTGAGATCT -> GTTGAGATCTA
CCACTTCTAGC -> CACTTCTAGCC
TCTAACATCCA -> CTAACATCCAT
ATGGCGCAACG -> TGGCGCAACGC
ACCAGAGGAGC -> CCAGAGGAGCA
AAGACCGCAAT -> AGACCGCAATG
TGAATGCTTAC -> GAATGCTTACA
AATGCCAGACC -> ATGCCAGACCC
TGTGTAAGTCT -> GTGTAAGTCTA
AGTTATATTAT -> GTTATATTATA
CTAAAGACTTG -> TAAAGACTTGA
GGTACACCGAC -> GTACACCGACC
CTCTGACTACC -> TCTGACTACCA
ACCGCAGGAGC -> CCGCAGGAGCT
CGGTCAGTGAT -> GGTCAGTGATC
CGCCATTTGTG -> GCCATTTGTGC
TTACTGTGCAG -> TACTGTGCAGT
AGTTATGTAAA -> GTTATGTAAAT
AGGATCCAGAT -> GGATCCAGATA
ATGGCTCCAAC -> TGGCTCCAACT
TACGGCCTAGG -> ACGGCCTAGGC
TCACCACGGAT -> CACCACGGATG
TGAACCGCAGG -> GAACCGCAGGA
GAATCACTGGC -> AATCACTGGCG
ATTAGCACCTG -> TTAGCACCTGT
TTAAAGCATAC -> TAAAGCATACA
CATACATCAAT -> ATACATCAATT
TGCGGCTCTGG -> GCGGCTCTGGA
GGTGTACAGCC -> GTGTACAGCCA
TCTCAGACCTA -> CTCAGACCTAA
TACTGTGCAGT -> ACTGTGCAGTC
GTTATGCTCAC -> TTATGCTCACA
ACTGGGCGCAG -> CTGGGCGCAGT
ATAATGCCAGA -> TAATGCCAGAC
GTTGAACCGCA -> TTGAACCGCAG
CCGTGCTTACA -> CGTGCTTACAG
TCGGCGGCGAC -> CGGCGGCGACT
GGCGCCTTACT -> GCGCCTTACTG
GCCATTTGTGC -> CCATTTGTGCA
CTAGGCCGCTG -> TAGGCCGCTGT
GCCTCGCGTCC -> CCTCGCGTCCA
CTAATCACCAC -> TAATCACCACG
TTCATTGCTGA -> TCATTGCTGAT
TGCATATCTAC -> GCATATCTACT
CCAGACCCCCT -> CAGACCCCCTC
AGCATACATCA -> GCATACATCAA
AAAGCATACAT -> AAGCATACATC
GAAGCGTGAGG -> AAGCGTGAGGA
TCGCGTCCAAC -> CGCGTCCAACT
ACATCCATTAT -> CATCCATTATC
TTACACTACGC -> TACACTACGCA
TACGATGCCAC -> ACGATGCCACA
CAAATGCGAGT -> AAATGCGAGTA
TTCTGACTTGG -> TCTGACTTGGT
TGGCTCCAACT -> GGCTCCAACTG
CATCATAGATT -> ATCATAGATTG
GTCACGATGCA -> TCACGATGCAG
CAACAAGGGCG -> AACAAGGGCGC
ACTTGCGTCAC -> CTTGCGTCACG
CAGGAGGGTGT -> AGGAGGGTGTC
AAGTCCTGCCC -> AGTCCTGCCCG
